AAAAACGATTA -> AAAACGATTAC
AAAAAGGTATC -> AAAAGGTATCC
AAAAATCATGG -> AAAATCATGGT
AAAACGATTAC -> AAACGATTACC
AAAACGGGACC -> AAACGGGACCA
AAAACGGTCGC -> AAACGGTCGCT
AAAAGAAGGCC -> AAAGAAGGCCT
AAAAGGGCGAG -> AAAGGGCGAGA
AAAAGGTATCC -> AAAGGTATCCC
AAAATCAACAT -> AAATCAACATT
AAAATCATGGT -> AAATCATGGTC
AAAATGATCAC -> AAATGATCACT
AAACAGGTAAG -> AACAGGTAAGT
AAACCAGAGGT -> AACCAGAGGTG
AAACGATTACC -> AACGATTACCT
AAACGCCATCA -> AACGCCATCAC
AAACGGCACAG -> AACGGCACAGG
AAACGGGACCA -> AACGGGACCAT
AAACGGTCGCT -> AACGGTCGCTC
AAACGTACTCC -> AACGTACTCCC
AAACGTCCTAG -> AACGTCCTAGG
AAACTCGCAAC -> AACTCGCAACA
AAACTGAGCAG -> AACTGAGCAGA
AAAGAAGCGAC -> AAGAAGCGACG
AAAGAAGGCCT -> AAGAAGGCCTT
AAAGATTAACT -> AAGATTAACTG
AAAGCAGCAAA -> AAGCAGCAAAA
AAAGCCTCGTA -> AAGCCTCGTAA
AAAGGACTCAC -> AAGGACTCACC
AAAGGGCGAGA -> AAGGGCGAGAT
AAAGGTATCCC -> AAGGTATCCCT
AAAGTGAACTC -> AAGTGAACTCC
AAAGTTAAAAG -> AAGTTAAAAGA
AAAGTTCTTTC -> AAGTTCTTTCT
AAATATAACTT -> AATATAACTTC
AAATCAACATT -> AATCAACATTA
AAATCATGGTC -> AATCATGGTCC
AAATGAATACC -> AATGAATACCT
AAATGATCACT -> AATGATCACTA
AAATGTCCACG -> AATGTCCACGT
AAATGTTGAGT -> AATGTTGAGTT
AACAAAAACGA -> ACAAAAACGAT
AACAAGCCGGA -> ACAAGCCGGAG
AACAATAATCA -> ACAATAATCAT
AACACTCCTCG -> ACACTCCTCGA
AACACTGTGGC -> ACACTGTGGCT
AACAGGTAAGT -> ACAGGTAAGTC
AACATTATGAA -> ACATTATGAAT
AACATTCGGCA -> ACATTCGGCAA
AACCAGAGGTG -> ACCAGAGGTGT
AACCAGCCTCA -> ACCAGCCTCAA
AACCAGTAGAC -> ACCAGTAGACC
AACCTAAACGT -> ACCTAAACGTC
AACCTAAGCCA -> ACCTAAGCCAT
AACGAGAGAAA -> ACGAGAGAAAA
AACGATTACCT -> ACGATTACCTC
AACGCAGGGAT -> ACGCAGGGATC
AACGCCATCAC -> ACGCCATCACA
AACGGCACAGG -> ACGGCACAGGG
AACGGGACCAT -> ACGGGACCATC
AACGGGAGCTA -> ACGGGAGCTAG
AACGGGCTCAG -> ACGGGCTCAGT
AACGGTCGCTC -> ACGGTCGCTCT
AACGTACTCCC -> ACGTACTCCCG
AACGTAGACCC -> ACGTAGACCCG
AACGTCCTAGG -> ACGTCCTAGGC
AACGTTTGTCG -> ACGTTTGTCGC
AACTACCAATG -> ACTACCAATGA
AACTATCCACT -> ACTATCCACTC
AACTCCACGCC -> ACTCCACGCCG
AACTCGCAACA -> ACTCGCAACAC
AACTCGCTAGG -> ACTCGCTAGGA
AACTCTGAAGC -> ACTCTGAAGCC
AACTGACACTA -> ACTGACACTAC
AACTGAGCAGA -> ACTGAGCAGAC
AACTGAGGCTC -> ACTGAGGCTCA
AACTGCACATT -> ACTGCACATTA
AACTGCCAGCC -> ACTGCCAGCCG
AACTTAAGGTT -> ACTTAAGGTTA
AACTTCCGGTT -> ACTTCCGGTTG
AACTTGCAACC -> ACTTGCAACCA
AAGAAGCGACG -> AGAAGCGACGG
AAGAAGGCCTT -> AGAAGGCCTTG
AAGAGTTTGGG -> AGAGTTTGGGC
AAGATTAACTG -> AGATTAACTGC
AAGCAGCAAAA -> AGCAGCAAAAG
AAGCCATTGTC -> AGCCATTGTCT
AAGCCCCTCCG -> AGCCCCTCCGA
AAGCCGCAGTT -> AGCCGCAGTTG
AAGCCGGAGCA -> AGCCGGAGCAT
AAGCCTCGTAA -> AGCCTCGTAAC
AAGCGACAAAA -> AGCGACAAAAA
AAGCGACGGAC -> AGCGACGGACA
AAGCTTAAACC -> AGCTTAAACCA
AAGGACGACTA -> AGGACGACTAG
AAGGACTCACC -> AGGACTCACCT
AAGGATGATTC -> AGGATGATTCC
AAGGCCGATGA -> AGGCCGATGAG
AAGGCCTTGTC -> AGGCCTTGTCA
AAGGCGCTAAC -> AGGCGCTAACG
AAGGGCGAGAT -> AGGGCGAGATG
AAGGGGTGTTA -> AGGGGTGTTAG
AAGGGTCTTTG -> AGGGTCTTTGT
AAGGGTGCGTA -> AGGGTGCGTAG
AAGGTACGACG -> AGGTACGACGG
AAGGTATACTT -> AGGTATACTTA
AAGGTATCCCT -> AGGTATCCCTG
AAGGTGCATAC -> AGGTGCATACA
AAGGTTACATA -> AGGTTACATAA
AAGTACCCTCG -> AGTACCCTCGC
AAGTCACATTG -> AGTCACATTGT
AAGTCGCAATG -> AGTCGCAATGG
AAGTCTTTCCT -> AGTCTTTCCTA
AAGTGAACTCC -> AGTGAACTCCA
AAGTGGGTATC -> AGTGGGTATCA
AAGTTAAAAGA -> AGTTAAAAGAA
AAGTTATGTCA -> AGTTATGTCAG
AAGTTCTTTCT -> AGTTCTTTCTC
AAGTTTCCGCA -> AGTTTCCGCAA
AATAACTGCAC -> ATAACTGCACA
AATAATAACTG -> ATAATAACTGC
AATAATCATGA -> ATAATCATGAC
AATACCTCTTG -> ATACCTCTTGT
AATAGTGAAGG -> ATAGTGAAGGC
AATATAACTTC -> ATATAACTTCC
AATCAACATTA -> ATCAACATTAT
AATCATGACTC -> ATCATGACTCA
AATCATGGTCC -> ATCATGGTCCC
AATCCGAGCAT -> ATCCGAGCATC
AATCCGCACAA -> ATCCGCACAAG
AATCCGGGTGG -> ATCCGGGTGGC
AATCCTGGTAC -> ATCCTGGTACT
AATCGAGGTTG -> ATCGAGGTTGG
AATCGGTTCGG -> ATCGGTTCGGG
AATGAAAGTTC -> ATGAAAGTTCT
AATGAACGTAG -> ATGAACGTAGA
AATGAATACCT -> ATGAATACCTC
AATGAGAAACA -> ATGAGAAACAG
AATGAGCGCTG -> ATGAGCGCTGG
AATGATCACTA -> ATGATCACTAA
AATGGCTGATG -> ATGGCTGATGA
AATGGTTTATC -> ATGGTTTATCT
AATGTCCACGT -> ATGTCCACGTA
AATGTCTTGAT -> ATGTCTTGATA
AATGTGTGGGA -> ATGTGTGGGAC
AATGTTGAGTT -> ATGTTGAGTTC
AATTAATTCTG -> ATTAATTCTGT
AATTACAAACT -> ATTACAAACTG
AATTCGAAAAC -> ATTCGAAAACG
AATTCTGTCTG -> ATTCTGTCTGG
ACAAAAACGAT -> CAAAAACGATT
ACAAAAATCAT -> CAAAAATCATG
ACAAACGGCAC -> CAAACGGCACA
ACAAACTGAGC -> CAAACTGAGCA
ACAACAATAAT -> CAACAATAATC
ACAACCAGTAG -> CAACCAGTAGA
ACAACGCAGGG -> CAACGCAGGGA
ACAAGCCGGAG -> CAAGCCGGAGC
ACAAGGACGAC -> CAAGGACGACT
ACAAGGTATAC -> CAAGGTATACT
ACAAGTGGGTA -> CAAGTGGGTAT
ACAATAATCAT -> CAATAATCATG
ACAATGAAAGT -> CAATGAAAGTT
ACACAGGTGGT -> CACAGGTGGTA
ACACATCCTCT -> CACATCCTCTT
ACACTACCACG -> CACTACCACGA
ACACTCCTCGA -> CACTCCTCGAC
ACACTGTGGCT -> CACTGTGGCTT
ACAGAGCCCTA -> CAGAGCCCTAC
ACAGATTCCCG -> CAGATTCCCGA
ACAGGAAGGTA -> CAGGAAGGTAC
ACAGGGTCTCC -> CAGGGTCTCCC
ACAGGTAAGTC -> CAGGTAAGTCA
ACAGGTCATTG -> CAGGTCATTGT
ACAGGTGGTAC -> CAGGTGGTACA
ACAGGTTACCA -> CAGGTTACCAC
ACAGTATCGTT -> CAGTATCGTTA
ACAGTATGAAA -> CAGTATGAAAG
ACAGTCAAAGA -> CAGTCAAAGAT
ACAGTGCCTCG -> CAGTGCCTCGC
ACATAAAATGA -> CATAAAATGAT
ACATAGTGACA -> CATAGTGACAG
ACATCCTCTTG -> CATCCTCTTGT
ACATGAAGCGA -> CATGAAGCGAC
ACATTACCTCT -> CATTACCTCTT
ACATTATGAAT -> CATTATGAATG
ACATTCGGCAA -> CATTCGGCAAT
ACATTGTGATA -> CATTGTGATAA
ACATTTAATCG -> CATTTAATCGA
ACATTTCAAAA -> CATTTCAAAAT
ACCAATGAACG -> CCAATGAACGT
ACCAATTACAA -> CCAATTACAAA
ACCACACAGGT -> CCACACAGGTG
ACCACGAGTTA -> CCACGAGTTAC
ACCAGAGGTGT -> CCAGAGGTGTT
ACCAGCCTCAA -> CCAGCCTCAAG
ACCAGCGGCTC -> CCAGCGGCTCG
ACCAGTAGACC -> CCAGTAGACCA
ACCATCTCCGG -> CCATCTCCGGA
ACCCATTCAAG -> CCCATTCAAGT
ACCCCACGATC -> CCCCACGATCG
ACCCCTCACCG -> CCCCTCACCGG
ACCCCTGTTGG -> CCCCTGTTGGA
ACCCGCTGCCT -> CCCGCTGCCTC
ACCCGTAACAA -> CCCGTAACAAA
ACCCTCGCACC -> CCCTCGCACCT
ACCGCGTTATG -> CCGCGTTATGA
ACCGGAAATAT -> CCGGAAATATA
ACCGGATCTGG -> CCGGATCTGGC
ACCGGGAACTA -> CCGGGAACTAC
ACCTAAACGTC -> CCTAAACGTCC
ACCTAAGCCAT -> CCTAAGCCATT
ACCTAAGGCGC -> CCTAAGGCGCT
ACCTACGGAAC -> CCTACGGAACA
ACCTCTACATT -> CCTCTACATTT
ACCTCTTATGC -> CCTCTTATGCA
ACCTCTTCTAT -> CCTCTTCTATC
ACCTCTTGTCA -> CCTCTTGTCAG
ACCTCTTTACG -> CCTCTTTACGA
ACGACCCCTGT -> CGACCCCTGTT
ACGACGGTTGG -> CGACGGTTGGG
ACGACTAGCAC -> CGACTAGCACT
ACGAGAGAAAA -> CGAGAGAAAAA
ACGAGGATGAC -> CGAGGATGACG
ACGAGTTACCC -> CGAGTTACCCA
ACGATCGCATC -> CGATCGCATCC
ACGATTACCTC -> CGATTACCTCT
ACGATTCTCTT -> CGATTCTCTTG
ACGCAGGGATC -> CGCAGGGATCC
ACGCCATCACA -> CGCCATCACAA
ACGCCGGAATG -> CGCCGGAATGA
ACGCCTTCCCG -> CGCCTTCCCGA
ACGCTGTTGGT -> CGCTGTTGGTC
ACGGAACACTC -> CGGAACACTCC
ACGGACAGTAT -> CGGACAGTATC
ACGGCACAGGG -> CGGCACAGGGT
ACGGGAACGAG -> CGGGAACGAGA
ACGGGACCATC -> CGGGACCATCT
ACGGGAGCTAG -> CGGGAGCTAGT
ACGGGCTCAGT -> CGGGCTCAGTA
ACGGTCGCTCT -> CGGTCGCTCTC
ACGGTTGGGTA -> CGGTTGGGTAC
ACGTACTCCCG -> CGTACTCCCGT
ACGTAGACCCG -> CGTAGACCCGT
ACGTAGCTAGG -> CGTAGCTAGGC
ACGTCCCCTCG -> CGTCCCCTCGG
ACGTCCTAGGC -> CGTCCTAGGCA
ACGTGCTAACT -> CGTGCTAACTA
ACGTTTGCACA -> CGTTTGCACAG
ACGTTTGTCGC -> CGTTTGTCGCA
ACTAAGGGGTG -> CTAAGGGGTGT
ACTACCAATGA -> CTACCAATGAA
ACTACCACGAG -> CTACCACGAGT
ACTAGCACTGT -> CTAGCACTGTG
ACTATCCACTC -> CTATCCACTCC
ACTATCCCTGT -> CTATCCCTGTC
ACTCAAAACGG -> CTCAAAACGGT
ACTCAAACGTA -> CTCAAACGTAC
ACTCACCTACG -> CTCACCTACGG
ACTCACGGGAA -> CTCACGGGAAC
ACTCCACGCCG -> CTCCACGCCGG
ACTCCCCCATA -> CTCCCCCATAC
ACTCCCGTCGG -> CTCCCGTCGGT
ACTCCTCGACA -> CTCCTCGACAA
ACTCCTGAACT -> CTCCTGAACTG
ACTCGCAACAC -> CTCGCAACACT
ACTCGCATTCA -> CTCGCATTCAC
ACTCGCTAGGA -> CTCGCTAGGAC
ACTCTCAAGTC -> CTCTCAAGTCG
ACTCTGAAGCC -> CTCTGAAGCCG
ACTGACACTAC -> CTGACACTACC
ACTGAGCAGAC -> CTGAGCAGACA
ACTGAGGCTCA -> CTGAGGCTCAT
ACTGCACATTA -> CTGCACATTAC
ACTGCCAGCCG -> CTGCCAGCCGA
ACTGTCAATGA -> CTGTCAATGAG
ACTGTCCCTAC -> CTGTCCCTACT
ACTGTGCAGCC -> CTGTGCAGCCT
ACTGTGGCTTC -> CTGTGGCTTCC
ACTGTGGCTTG -> CTGTGGCTTGT
ACTTAAGGTTA -> CTTAAGGTTAC
ACTTACGCTGT -> CTTACGCTGTT
ACTTCCGGTTG -> CTTCCGGTTGT
ACTTGACATGA -> CTTGACATGAA
ACTTGCAACCA -> CTTGCAACCAG
ACTTTGATATA -> CTTTGATATAA
AGAAAAAGGTA -> GAAAAAGGTAT
AGAAACAGGTA -> GAAACAGGTAA
AGAAATGTCCA -> GAAATGTCCAC
AGAAGCGACGG -> GAAGCGACGGA
AGAAGGCCTTG -> GAAGGCCTTGT
AGAAGTTTCCG -> GAAGTTTCCGC
AGAATCCGGGT -> GAATCCGGGTG
AGACAAGGTAT -> GACAAGGTATA
AGACAGTATGA -> GACAGTATGAA
AGACCAGCGGC -> GACCAGCGGCT
AGACCCGTAAC -> GACCCGTAACA
AGACGTCCCCT -> GACGTCCCCTC
AGACTCGCATT -> GACTCGCATTC
AGAGAAAAAGG -> GAGAAAAAGGT
AGAGCCCTACT -> GAGCCCTACTC
AGAGGTACTAT -> GAGGTACTATC
AGAGGTGTTAA -> GAGGTGTTAAA
AGAGTTTGGGC -> GAGTTTGGGCT
AGATAGAAATG -> GATAGAAATGT
AGATCCGGCCG -> GATCCGGCCGT
AGATGTGGGCA -> GATGTGGGCAA
AGATTAACTGC -> GATTAACTGCC
AGATTCCCGAA -> GATTCCCGAAC
AGATTCTTCAG -> GATTCTTCAGA
AGCAAAAGGGC -> GCAAAAGGGCG
AGCACTGTGGC -> GCACTGTGGCT
AGCAGACAAGG -> GCAGACAAGGT
AGCAGCAAAAG -> GCAGCAAAAGG
AGCATAAGCCC -> GCATAAGCCCC
AGCATCAATTA -> GCATCAATTAA
AGCCACAGGTT -> GCCACAGGTTA
AGCCATTGTCT -> GCCATTGTCTT
AGCCCCGGCGC -> GCCCCGGCGCG
AGCCCCTCCGA -> GCCCCTCCGAT
AGCCCTACTCA -> GCCCTACTCAA
AGCCGAATAAT -> GCCGAATAATA
AGCCGCAGTTG -> GCCGCAGTTGA
AGCCGGAGCAT -> GCCGGAGCATA
AGCCTCAAGGT -> GCCTCAAGGTG
AGCCTCGTAAC -> GCCTCGTAACA
AGCCTGCCTAG -> GCCTGCCTAGA
AGCGACAAAAA -> GCGACAAAAAT
AGCGACGGACA -> GCGACGGACAG
AGCGCTGGGAG -> GCGCTGGGAGT
AGCGGCTCGTA -> GCGGCTCGTAC
AGCGTTCTGGG -> GCGTTCTGGGT
AGCTAGGCAGA -> GCTAGGCAGAA
AGCTAGTAGTA -> GCTAGTAGTAG
AGCTCCCAACA -> GCTCCCAACAA
AGCTTAAACCA -> GCTTAAACCAG
AGCTTCAGTGA -> GCTTCAGTGAA
AGGAAGGTACG -> GGAAGGTACGA
AGGACCCGCTG -> GGACCCGCTGC
AGGACGACTAG -> GGACGACTAGC
AGGACTCACCT -> GGACTCACCTA
AGGACTTGACA -> GGACTTGACAT
AGGATGACGTG -> GGATGACGTGC
AGGATGATTCC -> GGATGATTCCT
AGGCAATCCGA -> GGCAATCCGAG
AGGCAGAATCC -> GGCAGAATCCG
AGGCCGATGAG -> GGCCGATGAGG
AGGCCTTGTCA -> GGCCTTGTCAG
AGGCGCTAACG -> GGCGCTAACGG
AGGCTCATACC -> GGCTCATACCG
AGGGATCCTGG -> GGGATCCTGGA
AGGGCGAGATG -> GGGCGAGATGT
AGGGGTGTTAG -> GGGGTGTTAGA
AGGGTCTCCCA -> GGGTCTCCCAA
AGGGTCTTTGT -> GGGTCTTTGTA
AGGGTGCGTAG -> GGGTGCGTAGC
AGGTAAGTCAC -> GGTAAGTCACA
AGGTACGACGG -> GGTACGACGGT
AGGTACTATCC -> GGTACTATCCC
AGGTATACTTA -> GGTATACTTAC
AGGTATCCCTG -> GGTATCCCTGG
AGGTCATTGTC -> GGTCATTGTCC
AGGTGCATACA -> GGTGCATACAT
AGGTGGGATTC -> GGTGGGATTCT
AGGTGGTACAA -> GGTGGTACAAC
AGGTGTTAAAT -> GGTGTTAAATG
AGGTTACATAA -> GGTTACATAAA
AGGTTACCACA -> GGTTACCACAC
AGGTTGGAAAG -> GGTTGGAAAGT
AGTAAAGCCTC -> GTAAAGCCTCG
AGTACCCTCGC -> GTACCCTCGCA
AGTAGACAGTA -> GTAGACAGTAT
AGTAGACCAGC -> GTAGACCAGCG
AGTAGAGGTAC -> GTAGAGGTACT
AGTAGTAGAGG -> GTAGTAGAGGT
AGTATACTGTC -> GTATACTGTCC
AGTATCGTTAA -> GTATCGTTAAT
AGTATGAAAGG -> GTATGAAAGGA
AGTCAAAGATT -> GTCAAAGATTA
AGTCACATTGT -> GTCACATTGTG
AGTCGCAATGG -> GTCGCAATGGT
AGTCGCGACCG -> GTCGCGACCGC
AGTCTTTCCTA -> GTCTTTCCTAT
AGTGAACTCCA -> GTGAACTCCAC
AGTGAACTTAA -> GTGAACTTAAG
AGTGAAGGCCG -> GTGAAGGCCGA
AGTGACAGTGC -> GTGACAGTGCC
AGTGAGCTTCA -> GTGAGCTTCAG
AGTGCCTCGCA -> GTGCCTCGCAT
AGTGCTGCAGT -> GTGCTGCAGTT
AGTGGGTATCA -> GTGGGTATCAA
AGTGTGTCTCT -> GTGTGTCTCTC
AGTTAAAAGAA -> GTTAAAAGAAG
AGTTACCCATT -> GTTACCCATTC
AGTTATGTCAG -> GTTATGTCAGC
AGTTCATGCGC -> GTTCATGCGCC
AGTTCCGGCTG -> GTTCCGGCTGG
AGTTCGGGGCG -> GTTCGGGGCGT
AGTTCTTTCTC -> GTTCTTTCTCC
AGTTGAACTGA -> GTTGAACTGAC
AGTTTCCGCAA -> GTTTCCGCAAT
AGTTTGGGCTA -> GTTTGGGCTAA
ATAAAATGATC -> TAAAATGATCA
ATAAACTCGCA -> TAAACTCGCAA
ATAAAGAAGCG -> TAAAGAAGCGA
ATAACTGCACA -> TAACTGCACAT
ATAACTTCCGG -> TAACTTCCGGT
ATAACTTGCAA -> TAACTTGCAAC
ATAAGCCCCTC -> TAAGCCCCTCC
ATAAGTACCCT -> TAAGTACCCTC
ATAATAACTGC -> TAATAACTGCA
ATAATAGTGAA -> TAATAGTGAAG
ATAATCATGAC -> TAATCATGACT
ATACAGAGCCC -> TACAGAGCCCT
ATACATTTAAT -> TACATTTAATC
ATACATTTCAA -> TACATTTCAAA
ATACCGGAAAT -> TACCGGAAATA
ATACCTCTTGT -> TACCTCTTGTC
ATACGATTCTC -> TACGATTCTCT
ATACGTTTGCA -> TACGTTTGCAC
ATACTCCCCCA -> TACTCCCCCAT
ATACTGTCCCT -> TACTGTCCCTA
ATACTTACGCT -> TACTTACGCTG
ATAGAAATGTC -> TAGAAATGTCC
ATAGCGTTCTG -> TAGCGTTCTGG
ATAGTATACTG -> TAGTATACTGT
ATAGTGAAGGC -> TAGTGAAGGCC
ATAGTGACAGT -> TAGTGACAGTG
ATATAAACTCG -> TATAAACTCGC
ATATAACTTCC -> TATAACTTCCG
ATATACGTTTG -> TATACGTTTGC
ATATACTCCCC -> TATACTCCCCC
ATCAACATTAT -> TCAACATTATG
ATCAAGGATGA -> TCAAGGATGAT
ATCAATTAATT -> TCAATTAATTC
ATCACAAGGAC -> TCACAAGGACG
ATCACTAAGGG -> TCACTAAGGGG
ATCATAGCGTT -> TCATAGCGTTC
ATCATGACTCA -> TCATGACTCAA
ATCATGGTCCC -> TCATGGTCCCA
ATCCACTCCTG -> TCCACTCCTGA
ATCCATATACT -> TCCATATACTC
ATCCCTGGGTT -> TCCCTGGGTTT
ATCCCTGTCAT -> TCCCTGTCATA
ATCCGAGCATC -> TCCGAGCATCA
ATCCGCACAAG -> TCCGCACAAGT
ATCCGGCCGTT -> TCCGGCCGTTT
ATCCGGGTGGC -> TCCGGGTGGCC
ATCCTCTTGTT -> TCCTCTTGTTC
ATCCTGGATCT -> TCCTGGATCTT
ATCCTGGTACT -> TCCTGGTACTT
ATCGAGGTTGG -> TCGAGGTTGGA
ATCGCATCCAT -> TCGCATCCATA
ATCGGTTCGGG -> TCGGTTCGGGA
ATCGTCCTTGT -> TCGTCCTTGTA
ATCGTTAATGT -> TCGTTAATGTG
ATCTCCGGACC -> TCTCCGGACCG
ATCTGGCGAGT -> TCTGGCGAGTT
ATCTGGTTTAT -> TCTGGTTTATC
ATCTTCTATGA -> TCTTCTATGAT
ATGAAAGGACT -> TGAAAGGACTC
ATGAAAGTTCT -> TGAAAGTTCTT
ATGAACCTAAA -> TGAACCTAAAC
ATGAACGTAGA -> TGAACGTAGAC
ATGAAGCGACA -> TGAAGCGACAA
ATGAATACCTC -> TGAATACCTCT
ATGAATCCTGG -> TGAATCCTGGT
ATGAATGTCTT -> TGAATGTCTTG
ATGACAGTCAA -> TGACAGTCAAA
ATGACGTGCTA -> TGACGTGCTAA
ATGACTCAAAC -> TGACTCAAACG
ATGAGAAACAG -> TGAGAAACAGG
ATGAGCGCTGG -> TGAGCGCTGGG
ATGAGGACCCG -> TGAGGACCCGC
ATGATCACTAA -> TGATCACTAAG
ATGATTCCTTC -> TGATTCCTTCT
ATGATTCTCAT -> TGATTCTCATG
ATGCAAAGCAG -> TGCAAAGCAGC
ATGCGCCAAAG -> TGCGCCAAAGT
ATGGCCTTCTG -> TGGCCTTCTGA
ATGGCTGATGA -> TGGCTGATGAA
ATGGGGCCGTT -> TGGGGCCGTTT
ATGGGTCCATA -> TGGGTCCATAA
ATGGTCCCAGT -> TGGTCCCAGTG
ATGGTTTATCT -> TGGTTTATCTG
ATGTCAGCCCC -> TGTCAGCCCCG
ATGTCCACGTA -> TGTCCACGTAG
ATGTCTTGATA -> TGTCTTGATAC
ATGTGGGCAAC -> TGTGGGCAACT
ATGTGTGGGAC -> TGTGTGGGACT
ATGTTGAGTTC -> TGTTGAGTTCG
ATTAACTGCCA -> TTAACTGCCAG
ATTAAGAGTTT -> TTAAGAGTTTG
ATTAATTCTGT -> TTAATTCTGTC
ATTACAAACTG -> TTACAAACTGA
ATTACCTCTAC -> TTACCTCTACA
ATTACCTCTTT -> TTACCTCTTTA
ATTATGAATGT -> TTATGAATGTC
ATTCAAGTCTT -> TTCAAGTCTTT
ATTCACCTCTT -> TTCACCTCTTC
ATTCCCGAACG -> TTCCCGAACGG
ATTCCTTCTGG -> TTCCTTCTGGT
ATTCGAAAACG -> TTCGAAAACGG
ATTCGGCAATC -> TTCGGCAATCG
ATTCTCATGAC -> TTCTCATGACA
ATTCTCTTGGG -> TTCTCTTGGGA
ATTCTGCCACC -> TTCTGCCACCC
ATTCTGTCTGG -> TTCTGTCTGGA
ATTCTTCAGAT -> TTCTTCAGATC
ATTGATAAGTA -> TTGATAAGTAC
ATTGTCCCACA -> TTGTCCCACAT
ATTGTCTTGAG -> TTGTCTTGAGA
ATTGTGATAAT -> TTGTGATAATA
ATTGTGGGTCC -> TTGTGGGTCCA
ATTTAAATGAA -> TTTAAATGAAT
ATTTAATCGAG -> TTTAATCGAGG
ATTTCAAAATC -> TTTCAAAATCA
ATTTGCCGTAT -> TTTGCCGTATA
ATTTTTGAAGG -> TTTTTGAAGGG
CAAAAACGATT -> AAAAACGATTA
CAAAAATCATG -> AAAAATCATGG
CAAAACGGTCG -> AAAACGGTCGC
CAAAAGGGCGA -> AAAAGGGCGAG
CAAAATCAACA -> AAAATCAACAT
CAAACGGCACA -> AAACGGCACAG
CAAACGTACTC -> AAACGTACTCC
CAAACTGAGCA -> AAACTGAGCAG
CAAAGATTAAC -> AAAGATTAACT
CAAAGCAGCAA -> AAAGCAGCAAA
CAAAGTGAACT -> AAAGTGAACTC
CAACAAGCCGG -> AACAAGCCGGA
CAACAATAATC -> AACAATAATCA
CAACACTGTGG -> AACACTGTGGC
CAACATTATGA -> AACATTATGAA
CAACCAGCCTC -> AACCAGCCTCA
CAACCAGTAGA -> AACCAGTAGAC
CAACCTAAGCC -> AACCTAAGCCA
CAACGCAGGGA -> AACGCAGGGAT
CAACTCTGAAG -> AACTCTGAAGC
CAAGCCGGAGC -> AAGCCGGAGCA
CAAGGACGACT -> AAGGACGACTA
CAAGGATGATT -> AAGGATGATTC
CAAGGGTCTTT -> AAGGGTCTTTG
CAAGGTATACT -> AAGGTATACTT
CAAGGTGCATA -> AAGGTGCATAC
CAAGTCGCAAT -> AAGTCGCAATG
CAAGTCTTTCC -> AAGTCTTTCCT
CAAGTGGGTAT -> AAGTGGGTATC
CAATAATCATG -> AATAATCATGA
CAATCCGAGCA -> AATCCGAGCAT
CAATCCGCACA -> AATCCGCACAA
CAATCGGTTCG -> AATCGGTTCGG
CAATGAAAGTT -> AATGAAAGTTC
CAATGAACGTA -> AATGAACGTAG
CAATGAGCGCT -> AATGAGCGCTG
CAATGGTTTAT -> AATGGTTTATC
CAATTAATTCT -> AATTAATTCTG
CAATTACAAAC -> AATTACAAACT
CAATTCGAAAA -> AATTCGAAAAC
CACAACAATAA -> ACAACAATAAT
CACAAGGACGA -> ACAAGGACGAC
CACAAGTGGGT -> ACAAGTGGGTA
CACACAGGTGG -> ACACAGGTGGT
CACACATCCTC -> ACACATCCTCT
CACAGGAAGGT -> ACAGGAAGGTA
CACAGGGTCTC -> ACAGGGTCTCC
CACAGGTCATT -> ACAGGTCATTG
CACAGGTGGTA -> ACAGGTGGTAC
CACAGGTTACC -> ACAGGTTACCA
CACATAGTGAC -> ACATAGTGACA
CACATCCTCTT -> ACATCCTCTTG
CACATTACCTC -> ACATTACCTCT
CACATTGTGAT -> ACATTGTGATA
CACCCCACGAT -> ACCCCACGATC
CACCGGATCTG -> ACCGGATCTGG
CACCTACGGAA -> ACCTACGGAAC
CACCTCTTATG -> ACCTCTTATGC
CACCTCTTCTA -> ACCTCTTCTAT
CACGAGTTACC -> ACGAGTTACCC
CACGATCGCAT -> ACGATCGCATC
CACGCCGGAAT -> ACGCCGGAATG
CACGGGAACGA -> ACGGGAACGAG
CACGTAGCTAG -> ACGTAGCTAGG
CACTAAGGGGT -> ACTAAGGGGTG
CACTACCACGA -> ACTACCACGAG
CACTCCTCGAC -> ACTCCTCGACA
CACTCCTGAAC -> ACTCCTGAACT
CACTGTGCAGC -> ACTGTGCAGCC
CACTGTGGCTT -> ACTGTGGCTTC,ACTGTGGCTTG
CAGAATCCGGG -> AGAATCCGGGT
CAGACAAGGTA -> AGACAAGGTAT
CAGAGCCCTAC -> AGAGCCCTACT
CAGAGGTGTTA -> AGAGGTGTTAA
CAGATAGAAAT -> AGATAGAAATG
CAGATCCGGCC -> AGATCCGGCCG
CAGATTCCCGA -> AGATTCCCGAA
CAGATTCTTCA -> AGATTCTTCAG
CAGCAAAAGGG -> AGCAAAAGGGC
CAGCCCCGGCG -> AGCCCCGGCGC
CAGCCGAATAA -> AGCCGAATAAT
CAGCCTCAAGG -> AGCCTCAAGGT
CAGCCTGCCTA -> AGCCTGCCTAG
CAGCGGCTCGT -> AGCGGCTCGTA
CAGCTCCCAAC -> AGCTCCCAACA
CAGGAAGGTAC -> AGGAAGGTACG
CAGGGATCCTG -> AGGGATCCTGG
CAGGGTCTCCC -> AGGGTCTCCCA
CAGGTAAGTCA -> AGGTAAGTCAC
CAGGTCATTGT -> AGGTCATTGTC
CAGGTGGTACA -> AGGTGGTACAA
CAGGTTACCAC -> AGGTTACCACA
CAGTAGACAGT -> AGTAGACAGTA
CAGTAGACCAG -> AGTAGACCAGC
CAGTATCGTTA -> AGTATCGTTAA
CAGTATGAAAG -> AGTATGAAAGG
CAGTCAAAGAT -> AGTCAAAGATT
CAGTCGCGACC -> AGTCGCGACCG
CAGTGAACTTA -> AGTGAACTTAA
CAGTGAGCTTC -> AGTGAGCTTCA
CAGTGCCTCGC -> AGTGCCTCGCA
CAGTTCCGGCT -> AGTTCCGGCTG
CAGTTGAACTG -> AGTTGAACTGA
CATAAAATGAT -> ATAAAATGATC
CATAAAGAAGC -> ATAAAGAAGCG
CATAACTTGCA -> ATAACTTGCAA
CATAAGCCCCT -> ATAAGCCCCTC
CATACATTTAA -> ATACATTTAAT
CATACATTTCA -> ATACATTTCAA
CATACCGGAAA -> ATACCGGAAAT
CATACGATTCT -> ATACGATTCTC
CATAGCGTTCT -> ATAGCGTTCTG
CATAGTGACAG -> ATAGTGACAGT
CATATACTCCC -> ATATACTCCCC
CATCAATTAAT -> ATCAATTAATT
CATCACAAGGA -> ATCACAAGGAC
CATCCATATAC -> ATCCATATACT
CATCCTCTTGT -> ATCCTCTTGTT
CATCTCCGGAC -> ATCTCCGGACC
CATGAAGCGAC -> ATGAAGCGACA
CATGACAGTCA -> ATGACAGTCAA
CATGACTCAAA -> ATGACTCAAAC
CATGCGCCAAA -> ATGCGCCAAAG
CATGGGTCCAT -> ATGGGTCCATA
CATGGTCCCAG -> ATGGTCCCAGT
CATTACCTCTT -> ATTACCTCTTT
CATTATGAATG -> ATTATGAATGT
CATTCAAGTCT -> ATTCAAGTCTT
CATTCACCTCT -> ATTCACCTCTT
CATTCGGCAAT -> ATTCGGCAATC
CATTGATAAGT -> ATTGATAAGTA
CATTGTCCCAC -> ATTGTCCCACA
CATTGTCTTGA -> ATTGTCTTGAG
CATTGTGATAA -> ATTGTGATAAT
CATTTAATCGA -> ATTTAATCGAG
CATTTCAAAAT -> ATTTCAAAATC
CCAAAGTGAAC -> CAAAGTGAACT
CCAACAAGCCG -> CAACAAGCCGG
CCAATGAACGT -> CAATGAACGTA
CCAATTACAAA -> CAATTACAAAC
CCAATTCGAAA -> CAATTCGAAAA
CCACAACAATA -> CACAACAATAA
CCACACAGGTG -> CACACAGGTGG
CCACACATCCT -> CACACATCCTC
CCACAGGTTAC -> CACAGGTTACC
CCACATAGTGA -> CACATAGTGAC
CCACCCCACGA -> CACCCCACGAT
CCACGAGTTAC -> CACGAGTTACC
CCACGATCGCA -> CACGATCGCAT
CCACGCCGGAA -> CACGCCGGAAT
CCACGTAGCTA -> CACGTAGCTAG
CCACTCCTGAA -> CACTCCTGAAC
CCAGAGGTGTT -> CAGAGGTGTTA
CCAGCCGAATA -> CAGCCGAATAA
CCAGCCTCAAG -> CAGCCTCAAGG
CCAGCGGCTCG -> CAGCGGCTCGT
CCAGCTCCCAA -> CAGCTCCCAAC
CCAGTAGACCA -> CAGTAGACCAG
CCAGTGAGCTT -> CAGTGAGCTTC
CCATAAAGAAG -> CATAAAGAAGC
CCATACATTTA -> CATACATTTAA
CCATATACTCC -> CATATACTCCC
CCATCACAAGG -> CATCACAAGGA
CCATCTCCGGA -> CATCTCCGGAC
CCATTCAAGTC -> CATTCAAGTCT
CCATTGATAAG -> CATTGATAAGT
CCATTGTCTTG -> CATTGTCTTGA
CCCAACAAGCC -> CCAACAAGCCG
CCCAATTCGAA -> CCAATTCGAAA
CCCACACATCC -> CCACACATCCT
CCCACATAGTG -> CCACATAGTGA
CCCACGATCGC -> CCACGATCGCA
CCCAGCTCCCA -> CCAGCTCCCAA
CCCAGTGAGCT -> CCAGTGAGCTT
CCCATACATTT -> CCATACATTTA
CCCATTCAAGT -> CCATTCAAGTC
CCCCACACATC -> CCCACACATCC
CCCCACGATCG -> CCCACGATCGC
CCCCATACATT -> CCCATACATTT
CCCCCATACAT -> CCCCATACATT
CCCCGGCGCGA -> CCCGGCGCGAT
CCCCTCACCGG -> CCCTCACCGGA
CCCCTCCGATG -> CCCTCCGATGG
CCCCTCGGAAG -> CCCTCGGAAGC
CCCCTGTTGGA -> CCCTGTTGGAC
CCCGAACGGGA -> CCGAACGGGAG
CCCGACCAATT -> CCGACCAATTA
CCCGCTGCCTC -> CCGCTGCCTCC
CCCGGCGCGAT -> CCGGCGCGATT
CCCGTAACAAA -> CCGTAACAAAA
CCCGTCGGTTT -> CCGTCGGTTTC
CCCTACTCAAA -> CCTACTCAAAA
CCCTACTCTCA -> CCTACTCTCAA
CCCTCACCGGA -> CCTCACCGGAT
CCCTCCGATGG -> CCTCCGATGGG
CCCTCGCACCT -> CCTCGCACCTC
CCCTCGGAAGC -> CCTCGGAAGCT
CCCTGGGTTTC -> CCTGGGTTTCA
CCCTGTCATAC -> CCTGTCATACG
CCCTGTTGGAC -> CCTGTTGGACC
CCGAACGGGAG -> CGAACGGGAGC
CCGAATAATAA -> CGAATAATAAC
CCGACCAATTA -> CGACCAATTAC
CCGAGCATCAA -> CGAGCATCAAT
CCGATGAGGAC -> CGATGAGGACC
CCGATGGGGCC -> CGATGGGGCCG
CCGCAATCCGC -> CGCAATCCGCA
CCGCACAAGTG -> CGCACAAGTGG
CCGCAGTTGAA -> CGCAGTTGAAC
CCGCGTTATGA -> CGCGTTATGAA
CCGCTGCCTCC -> CGCTGCCTCCG
CCGGAAATATA -> CGGAAATATAA
CCGGAATGAGA -> CGGAATGAGAA
CCGGACCGGGA -> CGGACCGGGAA
CCGGAGCATAA -> CGGAGCATAAG
CCGGATCTGGC -> CGGATCTGGCG
CCGGCCGTTTA -> CGGCCGTTTAC
CCGGCGCGATT -> CGGCGCGATTT
CCGGCTGGATG -> CGGCTGGATGG
CCGGGAACTAC -> CGGGAACTACC
CCGGGTGGCCC -> CGGGTGGCCCC
CCGGTTGTTTT -> CGGTTGTTTTA
CCGTAACAAAA -> CGTAACAAAAA
CCGTATAGTAT -> CGTATAGTATA
CCGTCGGTTTC -> CGTCGGTTTCT
CCGTGGCTTGC -> CGTGGCTTGCT
CCGTTTACAAT -> CGTTTACAATG
CCGTTTTTAAC -> CGTTTTTAACT
CCTAAACGTCC -> CTAAACGTCCT
CCTAACGTTTG -> CTAACGTTTGT
CCTAAGCCATT -> CTAAGCCATTG
CCTAAGGCGCT -> CTAAGGCGCTA
CCTACGGAACA -> CTACGGAACAC
CCTACTCAAAA -> CTACTCAAAAC
CCTACTCTCAA -> CTACTCTCAAG
CCTAGACTCGC -> CTAGACTCGCA
CCTAGGCAATC -> CTAGGCAATCC
CCTAGTAAAGC -> CTAGTAAAGCC
CCTATATACGT -> CTATATACGTT
CCTCAAGGTGC -> CTCAAGGTGCA
CCTCACCGGAT -> CTCACCGGATC
CCTCAGATTCT -> CTCAGATTCTT
CCTCCGATGGG -> CTCCGATGGGG
CCTCCGTGGCT -> CTCCGTGGCTT
CCTCGACAACC -> CTCGACAACCA
CCTCGCACCTC -> CTCGCACCTCT
CCTCGCATAAC -> CTCGCATAACT
CCTCGGAAGCT -> CTCGGAAGCTT
CCTCGGGCCTA -> CTCGGGCCTAA
CCTCGTAACAT -> CTCGTAACATT
CCTCTTATGCA -> CTCTTATGCAA
CCTCTTCTATC -> CTCTTCTATCA
CCTCTTGTCAG -> CTCTTGTCAGA
CCTCTTGTTCT -> CTCTTGTTCTT
CCTCTTTACGA -> CTCTTTACGAC
CCTGAACTGAG -> CTGAACTGAGG
CCTGCCTAGAC -> CTGCCTAGACT
CCTGGATCTTC -> CTGGATCTTCT
CCTGGGTTTCA -> CTGGGTTTCAA
CCTGGTACTTT -> CTGGTACTTTG
CCTGTCATACG -> CTGTCATACGA
CCTGTTGGACC -> CTGTTGGACCC
CCTTATTTGCC -> CTTATTTGCCG
CCTTCCCGACC -> CTTCCCGACCA
CCTTCTGACGA -> CTTCTGACGAG
CCTTCTGCCCA -> CTTCTGCCCAG
CCTTCTGGTTC -> CTTCTGGTTCA
CCTTGTACAGA -> CTTGTACAGAT
CCTTGTCAGTC -> CTTGTCAGTCG
CGAAAACGGGA -> GAAAACGGGAC
CGAACGGGAGC -> GAACGGGAGCT
CGAATAATAAC -> GAATAATAACT
CGAATGGCTGA -> GAATGGCTGAT
CGACAAAAATC -> GACAAAAATCA
CGACAACCAGT -> GACAACCAGTA
CGACCAATTAC -> GACCAATTACA
CGACCCCTGTT -> GACCCCTGTTG
CGACCGCGTTA -> GACCGCGTTAT
CGACGGACAGT -> GACGGACAGTA
CGACGGTTGGG -> GACGGTTGGGT
CGACTAGCACT -> GACTAGCACTG
CGAGAGAAAAA -> GAGAGAAAAAG
CGAGATGTGGG -> GAGATGTGGGC
CGAGCATCAAT -> GAGCATCAATT
CGAGGATGACG -> GAGGATGACGT
CGAGGTTGGAA -> GAGGTTGGAAA
CGAGTTACCCA -> GAGTTACCCAT
CGAGTTCATGC -> GAGTTCATGCG
CGATCGCATCC -> GATCGCATCCA
CGATGAGGACC -> GATGAGGACCC
CGATGGGGCCG -> GATGGGGCCGT
CGATTACCTCT -> GATTACCTCTA
CGATTCTCTTG -> GATTCTCTTGG
CGATTTAAATG -> GATTTAAATGA
CGCAACACTGT -> GCAACACTGTG
CGCAATCCGCA -> GCAATCCGCAC
CGCAATGGTTT -> GCAATGGTTTA
CGCACAAGTGG -> GCACAAGTGGG
CGCACCTCTTA -> GCACCTCTTAT
CGCACTGTGCA -> GCACTGTGCAG
CGCAGGGATCC -> GCAGGGATCCT
CGCAGTTGAAC -> GCAGTTGAACT
CGCATAACTTG -> GCATAACTTGC
CGCATCCATAT -> GCATCCATATA
CGCATTCACCT -> GCATTCACCTC
CGCCAAAGTGA -> GCCAAAGTGAA
CGCCATCACAA -> GCCATCACAAG
CGCCGGAATGA -> GCCGGAATGAG
CGCCTTCCCGA -> GCCTTCCCGAC
CGCGACCGCGT -> GCGACCGCGTT
CGCGATTTAAA -> GCGATTTAAAT
CGCGTTATGAA -> GCGTTATGAAC
CGCTAACGGGC -> GCTAACGGGCT
CGCTAGGACTT -> GCTAGGACTTG
CGCTCTCCTAG -> GCTCTCCTAGT
CGCTGCCTCCG -> GCTGCCTCCGT
CGCTGGGAGTG -> GCTGGGAGTGC
CGCTGTTGGTC -> GCTGTTGGTCG
CGGAAATATAA -> GGAAATATAAC
CGGAACACTCC -> GGAACACTCCT
CGGAAGCTTAA -> GGAAGCTTAAA
CGGAATGAGAA -> GGAATGAGAAA
CGGACAGTATC -> GGACAGTATCG
CGGACCGGGAA -> GGACCGGGAAC
CGGAGCATAAG -> GGAGCATAAGC
CGGATCTGGCG -> GGATCTGGCGA
CGGCAATCGGT -> GGCAATCGGTT
CGGCACAGGGT -> GGCACAGGGTC
CGGCCGTTTAC -> GGCCGTTTACA
CGGCGCGATTT -> GGCGCGATTTA
CGGCTCGTACG -> GGCTCGTACGC
CGGCTGGATGG -> GGCTGGATGGC
CGGGAACGAGA -> GGGAACGAGAG
CGGGAACTACC -> GGGAACTACCA
CGGGACCATCT -> GGGACCATCTC
CGGGAGCTAGT -> GGGAGCTAGTA
CGGGAGGTGGG -> GGGAGGTGGGA
CGGGCCTAACG -> GGGCCTAACGT
CGGGCTCAGTA -> GGGCTCAGTAG
CGGGGCGTACA -> GGGGCGTACAA
CGGGTGGCCCC -> GGGTGGCCCCA
CGGTCGCTCTC -> GGTCGCTCTCC
CGGTGCTCGAA -> GGTGCTCGAAT
CGGTTCGGGAG -> GGTTCGGGAGG
CGGTTGGGTAC -> GGTTGGGTACC
CGGTTGTTTTA -> GGTTGTTTTAT
CGGTTTCTCCT -> GGTTTCTCCTC
CGTAACAAAAA -> GTAACAAAAAC
CGTAACATTCG -> GTAACATTCGG
CGTACAAACGG -> GTACAAACGGC
CGTACGCCTTC -> GTACGCCTTCC
CGTACTCCCGT -> GTACTCCCGTC
CGTAGACCCGT -> GTAGACCCGTA
CGTAGCCACAG -> GTAGCCACAGG
CGTAGCTAGGC -> GTAGCTAGGCA
CGTATAGTATA -> GTATAGTATAC
CGTCCCCTCGG -> GTCCCCTCGGA
CGTCCTAGGCA -> GTCCTAGGCAA
CGTCCTTGTAC -> GTCCTTGTACA
CGTCGGTTTCT -> GTCGGTTTCTC
CGTGCTAACTA -> GTGCTAACTAT
CGTGGCTTGCT -> GTGGCTTGCTC
CGTTAATGTGT -> GTTAATGTGTG
CGTTATGAACC -> GTTATGAACCT
CGTTCTGGGTG -> GTTCTGGGTGG
CGTTTACAATG -> GTTTACAATGA
CGTTTGCACAG -> GTTTGCACAGG
CGTTTGTCGCA -> GTTTGTCGCAC
CGTTTTTAACT -> GTTTTTAACTC
CTAAACGCCAT -> TAAACGCCATC
CTAAACGTCCT -> TAAACGTCCTA
CTAACGGGCTC -> TAACGGGCTCA
CTAACGTTTGT -> TAACGTTTGTC
CTAACTATCCA -> TAACTATCCAC
CTAAGCCATTG -> TAAGCCATTGT
CTAAGGCGCTA -> TAAGGCGCTAA
CTAAGGGGTGT -> TAAGGGGTGTT
CTACCAATGAA -> TACCAATGAAC
CTACCACGAGT -> TACCACGAGTT
CTACGGAACAC -> TACGGAACACT
CTACTCAAAAC -> TACTCAAAACG
CTACTCTCAAG -> TACTCTCAAGT
CTAGACTCGCA -> TAGACTCGCAT
CTAGCACTGTG -> TAGCACTGTGG
CTAGGACTTGA -> TAGGACTTGAC
CTAGGCAATCC -> TAGGCAATCCG
CTAGGCAGAAT -> TAGGCAGAATC
CTAGTAAAGCC -> TAGTAAAGCCT
CTAGTAGTAGA -> TAGTAGTAGAG
CTATATACGTT -> TATATACGTTT
CTATCATAGCG -> TATCATAGCGT
CTATCCACTCC -> TATCCACTCCT
CTATCCCTGTC -> TATCCCTGTCA
CTATGATTCTC -> TATGATTCTCA
CTCAAAACGGT -> TCAAAACGGTC
CTCAAACGTAC -> TCAAACGTACT
CTCAAGGTGCA -> TCAAGGTGCAT
CTCAAGTCGCA -> TCAAGTCGCAA
CTCACAGGAAG -> TCACAGGAAGG
CTCACCGGATC -> TCACCGGATCT
CTCACCTACGG -> TCACCTACGGA
CTCACGGGAAC -> TCACGGGAACG
CTCAGATTCTT -> TCAGATTCTTC
CTCAGTAGACA -> TCAGTAGACAG
CTCATACCGGA -> TCATACCGGAA
CTCATGACAGT -> TCATGACAGTC
CTCCACGCCGG -> TCCACGCCGGA
CTCCCAACAAG -> TCCCAACAAGC
CTCCCAATTCG -> TCCCAATTCGA
CTCCCCCATAC -> TCCCCCATACA
CTCCCGTCGGT -> TCCCGTCGGTT
CTCCGATGGGG -> TCCGATGGGGC
CTCCGGACCGG -> TCCGGACCGGG
CTCCGTGGCTT -> TCCGTGGCTTG
CTCCTAGTAAA -> TCCTAGTAAAG
CTCCTCAGATT -> TCCTCAGATTC
CTCCTCGACAA -> TCCTCGACAAC
CTCCTCGGGCC -> TCCTCGGGCCT
CTCCTGAACTG -> TCCTGAACTGA
CTCCTTATTTG -> TCCTTATTTGC
CTCGAATGGCT -> TCGAATGGCTG
CTCGACAACCA -> TCGACAACCAG
CTCGCAACACT -> TCGCAACACTG
CTCGCACCTCT -> TCGCACCTCTT
CTCGCATAACT -> TCGCATAACTT
CTCGCATTCAC -> TCGCATTCACC
CTCGCTAGGAC -> TCGCTAGGACT
CTCGGAAGCTT -> TCGGAAGCTTA
CTCGGGCCTAA -> TCGGGCCTAAC
CTCGTAACATT -> TCGTAACATTC
CTCGTACGCCT -> TCGTACGCCTT
CTCTCAAGTCG -> TCTCAAGTCGC
CTCTCACAGGA -> TCTCACAGGAA
CTCTCCTAGTA -> TCTCCTAGTAA
CTCTGAAGCCG -> TCTGAAGCCGC
CTCTTATGCAA -> TCTTATGCAAA
CTCTTCTATCA -> TCTTCTATCAT
CTCTTGGGAAG -> TCTTGGGAAGT
CTCTTGTCAGA -> TCTTGTCAGAT
CTCTTGTTCTT -> TCTTGTTCTTA
CTCTTTACGAC -> TCTTTACGACC
CTGAACTGAGG -> TGAACTGAGGC
CTGAAGCCGCA -> TGAAGCCGCAG
CTGACACTACC -> TGACACTACCA
CTGACGAGGAT -> TGACGAGGATG
CTGAGCAGACA -> TGAGCAGACAA
CTGAGGCTCAT -> TGAGGCTCATA
CTGATGAATCC -> TGATGAATCCT
CTGCACATTAC -> TGCACATTACC
CTGCAGTTCCG -> TGCAGTTCCGG
CTGCCACCCCA -> TGCCACCCCAC
CTGCCAGCCGA -> TGCCAGCCGAA
CTGCCCAGCTC -> TGCCCAGCTCC
CTGCCTAGACT -> TGCCTAGACTC
CTGCCTCCGTG -> TGCCTCCGTGG
CTGGAGTGTGT -> TGGAGTGTGTC
CTGGATCTTCT -> TGGATCTTCTA
CTGGATGGCCT -> TGGATGGCCTT
CTGGCGAGTTC -> TGGCGAGTTCA
CTGGGAGTGCT -> TGGGAGTGCTG
CTGGGTGGATT -> TGGGTGGATTG
CTGGGTTTCAA -> TGGGTTTCAAC
CTGGTACTTTG -> TGGTACTTTGA
CTGGTTCAAGG -> TGGTTCAAGGG
CTGGTTTATCG -> TGGTTTATCGT
CTGTCAATGAG -> TGTCAATGAGC
CTGTCATACGA -> TGTCATACGAT
CTGTCCCTACT -> TGTCCCTACTC
CTGTCTGGAGT -> TGTCTGGAGTG
CTGTGCAGCCT -> TGTGCAGCCTG
CTGTGGCTTCC -> TGTGGCTTCCT
CTGTGGCTTGT -> TGTGGCTTGTC
CTGTTGGACCC -> TGTTGGACCCC
CTGTTGGTCGG -> TGTTGGTCGGT
CTTAAACCAGA -> TTAAACCAGAG
CTTAAGGTTAC -> TTAAGGTTACA
CTTACGCTGTT -> TTACGCTGTTG
CTTACTCACGG -> TTACTCACGGG
CTTATGCAAAG -> TTATGCAAAGC
CTTATTTGCCG -> TTATTTGCCGT
CTTCAGATCCG -> TTCAGATCCGG
CTTCAGTGAAC -> TTCAGTGAACT
CTTCCCGACCA -> TTCCCGACCAA
CTTCCGGTTGT -> TTCCGGTTGTT
CTTCCTTCTGC -> TTCCTTCTGCC
CTTCTATCATA -> TTCTATCATAG
CTTCTATGATT -> TTCTATGATTC
CTTCTGACGAG -> TTCTGACGAGG
CTTCTGCCCAG -> TTCTGCCCAGC
CTTCTGGTTCA -> TTCTGGTTCAA
CTTGACATGAA -> TTGACATGAAG
CTTGAGAAGTT -> TTGAGAAGTTT
CTTGATACAGA -> TTGATACAGAG
CTTGCAACCAG -> TTGCAACCAGC
CTTGCTCCTCA -> TTGCTCCTCAG
CTTGGGAAGTT -> TTGGGAAGTTA
CTTGTACAGAT -> TTGTACAGATT
CTTGTCAGATA -> TTGTCAGATAG
CTTGTCAGTCG -> TTGTCAGTCGC
CTTGTCATGGG -> TTGTCATGGGT
CTTGTTCTTAC -> TTGTTCTTACT
CTTTACGACCC -> TTTACGACCCC
CTTTCCTATAT -> TTTCCTATATA
CTTTCTCCTTA -> TTTCTCCTTAT
CTTTGATATAA -> TTTGATATAAA
CTTTGTATTAA -> TTTGTATTAAG
GAAAAAGGTAT -> AAAAAGGTATC
GAAAACGGGAC -> AAAACGGGACC
GAAACAGGTAA -> AAACAGGTAAG
GAAAGGACTCA -> AAAGGACTCAC
GAAAGTTAAAA -> AAAGTTAAAAG
GAAAGTTCTTT -> AAAGTTCTTTC
GAAATATAACT -> AAATATAACTT
GAAATGTCCAC -> AAATGTCCACG
GAACACTCCTC -> AACACTCCTCG
GAACCTAAACG -> AACCTAAACGT
GAACGAGAGAA -> AACGAGAGAAA
GAACGGGAGCT -> AACGGGAGCTA
GAACGTAGACC -> AACGTAGACCC
GAACTACCAAT -> AACTACCAATG
GAACTCCACGC -> AACTCCACGCC
GAACTGACACT -> AACTGACACTA
GAACTGAGGCT -> AACTGAGGCTC
GAACTTAAGGT -> AACTTAAGGTT
GAAGCCGCAGT -> AAGCCGCAGTT
GAAGCGACAAA -> AAGCGACAAAA
GAAGCGACGGA -> AAGCGACGGAC
GAAGCTTAAAC -> AAGCTTAAACC
GAAGGCCGATG -> AAGGCCGATGA
GAAGGCCTTGT -> AAGGCCTTGTC
GAAGGGTGCGT -> AAGGGTGCGTA
GAAGGTACGAC -> AAGGTACGACG
GAAGTTATGTC -> AAGTTATGTCA
GAAGTTTCCGC -> AAGTTTCCGCA
GAATAATAACT -> AATAATAACTG
GAATACCTCTT -> AATACCTCTTG
GAATCCGGGTG -> AATCCGGGTGG
GAATCCTGGTA -> AATCCTGGTAC
GAATGAGAAAC -> AATGAGAAACA
GAATGGCTGAT -> AATGGCTGATG
GAATGTCTTGA -> AATGTCTTGAT
GACAAAAATCA -> ACAAAAATCAT
GACAACCAGTA -> ACAACCAGTAG
GACAAGGTATA -> ACAAGGTATAC
GACACTACCAC -> ACACTACCACG
GACAGTATCGT -> ACAGTATCGTT
GACAGTATGAA -> ACAGTATGAAA
GACAGTCAAAG -> ACAGTCAAAGA
GACAGTGCCTC -> ACAGTGCCTCG
GACATGAAGCG -> ACATGAAGCGA
GACCAATTACA -> ACCAATTACAA
GACCAGCGGCT -> ACCAGCGGCTC
GACCATCTCCG -> ACCATCTCCGG
GACCCCTCACC -> ACCCCTCACCG
GACCCCTGTTG -> ACCCCTGTTGG
GACCCGCTGCC -> ACCCGCTGCCT
GACCCGTAACA -> ACCCGTAACAA
GACCGCGTTAT -> ACCGCGTTATG
GACCGGGAACT -> ACCGGGAACTA
GACGACTAGCA -> ACGACTAGCAC
GACGAGGATGA -> ACGAGGATGAC
GACGGACAGTA -> ACGGACAGTAT
GACGGTTGGGT -> ACGGTTGGGTA
GACGTCCCCTC -> ACGTCCCCTCG
GACGTGCTAAC -> ACGTGCTAACT
GACTAGCACTG -> ACTAGCACTGT
GACTCAAACGT -> ACTCAAACGTA
GACTCACCTAC -> ACTCACCTACG
GACTCGCATTC -> ACTCGCATTCA
GACTGTCAATG -> ACTGTCAATGA
GACTTGACATG -> ACTTGACATGA
GAGAAAAAGGT -> AGAAAAAGGTA
GAGAAACAGGT -> AGAAACAGGTA
GAGAAGTTTCC -> AGAAGTTTCCG
GAGAGAAAAAG -> AGAGAAAAAGG
GAGATGTGGGC -> AGATGTGGGCA
GAGCAGACAAG -> AGCAGACAAGG
GAGCATAAGCC -> AGCATAAGCCC
GAGCATCAATT -> AGCATCAATTA
GAGCCCTACTC -> AGCCCTACTCA
GAGCGCTGGGA -> AGCGCTGGGAG
GAGCTAGTAGT -> AGCTAGTAGTA
GAGCTTCAGTG -> AGCTTCAGTGA
GAGGACCCGCT -> AGGACCCGCTG
GAGGATGACGT -> AGGATGACGTG
GAGGCTCATAC -> AGGCTCATACC
GAGGTACTATC -> AGGTACTATCC
GAGGTGGGATT -> AGGTGGGATTC
GAGGTGTTAAA -> AGGTGTTAAAT
GAGGTTGGAAA -> AGGTTGGAAAG
GAGTGCTGCAG -> AGTGCTGCAGT
GAGTGTGTCTC -> AGTGTGTCTCT
GAGTTACCCAT -> AGTTACCCATT
GAGTTCATGCG -> AGTTCATGCGC
GAGTTCGGGGC -> AGTTCGGGGCG
GAGTTTGGGCT -> AGTTTGGGCTA
GATAAGTACCC -> ATAAGTACCCT
GATAATAGTGA -> ATAATAGTGAA
GATACAGAGCC -> ATACAGAGCCC
GATAGAAATGT -> ATAGAAATGTC
GATATAAACTC -> ATATAAACTCG
GATCACTAAGG -> ATCACTAAGGG
GATCCGGCCGT -> ATCCGGCCGTT
GATCCTGGATC -> ATCCTGGATCT
GATCGCATCCA -> ATCGCATCCAT
GATCTGGCGAG -> ATCTGGCGAGT
GATCTTCTATG -> ATCTTCTATGA
GATGAATCCTG -> ATGAATCCTGG
GATGACGTGCT -> ATGACGTGCTA
GATGAGGACCC -> ATGAGGACCCG
GATGATTCCTT -> ATGATTCCTTC
GATGGCCTTCT -> ATGGCCTTCTG
GATGGGGCCGT -> ATGGGGCCGTT
GATGTGGGCAA -> ATGTGGGCAAC
GATTAACTGCC -> ATTAACTGCCA
GATTACCTCTA -> ATTACCTCTAC
GATTCCCGAAC -> ATTCCCGAACG
GATTCCTTCTG -> ATTCCTTCTGG
GATTCTCATGA -> ATTCTCATGAC
GATTCTCTTGG -> ATTCTCTTGGG
GATTCTGCCAC -> ATTCTGCCACC
GATTCTTCAGA -> ATTCTTCAGAT
GATTGTGGGTC -> ATTGTGGGTCC
GATTTAAATGA -> ATTTAAATGAA
GCAAAAGGGCG -> CAAAAGGGCGA
GCAAAGCAGCA -> CAAAGCAGCAA
GCAACACTGTG -> CAACACTGTGG
GCAACCAGCCT -> CAACCAGCCTC
GCAACTCTGAA -> CAACTCTGAAG
GCAATCCGAGC -> CAATCCGAGCA
GCAATCCGCAC -> CAATCCGCACA
GCAATCGGTTC -> CAATCGGTTCG
GCAATGGTTTA -> CAATGGTTTAT
GCACAAGTGGG -> CACAAGTGGGT
GCACAGGGTCT -> CACAGGGTCTC
GCACAGGTCAT -> CACAGGTCATT
GCACATTACCT -> CACATTACCTC
GCACCTCTTAT -> CACCTCTTATG
GCACTGTGCAG -> CACTGTGCAGC
GCACTGTGGCT -> CACTGTGGCTT
GCAGAATCCGG -> CAGAATCCGGG
GCAGACAAGGT -> CAGACAAGGTA
GCAGCAAAAGG -> CAGCAAAAGGG
GCAGCCTGCCT -> CAGCCTGCCTA
GCAGGGATCCT -> CAGGGATCCTG
GCAGTTCCGGC -> CAGTTCCGGCT
GCAGTTGAACT -> CAGTTGAACTG
GCATAACTTGC -> CATAACTTGCA
GCATAAGCCCC -> CATAAGCCCCT
GCATACATTTC -> CATACATTTCA
GCATCAATTAA -> CATCAATTAAT
GCATCCATATA -> CATCCATATAC
GCATTCACCTC -> CATTCACCTCT
GCCAAAGTGAA -> CCAAAGTGAAC
GCCACAGGTTA -> CCACAGGTTAC
GCCACCCCACG -> CCACCCCACGA
GCCAGCCGAAT -> CCAGCCGAATA
GCCATCACAAG -> CCATCACAAGG
GCCATTGTCTT -> CCATTGTCTTG
GCCCAGCTCCC -> CCCAGCTCCCA
GCCCCACACAT -> CCCCACACATC
GCCCCGGCGCG -> CCCCGGCGCGA
GCCCCTCCGAT -> CCCCTCCGATG
GCCCTACTCAA -> CCCTACTCAAA
GCCGAATAATA -> CCGAATAATAA
GCCGATGAGGA -> CCGATGAGGAC
GCCGCAGTTGA -> CCGCAGTTGAA
GCCGGAATGAG -> CCGGAATGAGA
GCCGGAGCATA -> CCGGAGCATAA
GCCGTATAGTA -> CCGTATAGTAT
GCCGTTTACAA -> CCGTTTACAAT
GCCGTTTTTAA -> CCGTTTTTAAC
GCCTAACGTTT -> CCTAACGTTTG
GCCTAGACTCG -> CCTAGACTCGC
GCCTCAAGGTG -> CCTCAAGGTGC
GCCTCCGTGGC -> CCTCCGTGGCT
GCCTCGCATAA -> CCTCGCATAAC
GCCTCGTAACA -> CCTCGTAACAT
GCCTGCCTAGA -> CCTGCCTAGAC
GCCTTCCCGAC -> CCTTCCCGACC
GCCTTCTGACG -> CCTTCTGACGA
GCCTTGTCAGT -> CCTTGTCAGTC
GCGACAAAAAT -> CGACAAAAATC
GCGACCGCGTT -> CGACCGCGTTA
GCGACGGACAG -> CGACGGACAGT
GCGAGATGTGG -> CGAGATGTGGG
GCGAGTTCATG -> CGAGTTCATGC
GCGATTTAAAT -> CGATTTAAATG
GCGCCAAAGTG -> CGCCAAAGTGA
GCGCGATTTAA -> CGCGATTTAAA
GCGCTAACGGG -> CGCTAACGGGC
GCGCTGGGAGT -> CGCTGGGAGTG
GCGGCTCGTAC -> CGGCTCGTACG
GCGTACAAACG -> CGTACAAACGG
GCGTAGCCACA -> CGTAGCCACAG
GCGTTATGAAC -> CGTTATGAACC
GCGTTCTGGGT -> CGTTCTGGGTG
GCTAAACGCCA -> CTAAACGCCAT
GCTAACGGGCT -> CTAACGGGCTC
GCTAACTATCC -> CTAACTATCCA
GCTAGGACTTG -> CTAGGACTTGA
GCTAGGCAGAA -> CTAGGCAGAAT
GCTAGTAGTAG -> CTAGTAGTAGA
GCTCAGTAGAC -> CTCAGTAGACA
GCTCATACCGG -> CTCATACCGGA
GCTCCCAACAA -> CTCCCAACAAG
GCTCCTCAGAT -> CTCCTCAGATT
GCTCGAATGGC -> CTCGAATGGCT
GCTCGTACGCC -> CTCGTACGCCT
GCTCTCCTAGT -> CTCTCCTAGTA
GCTGATGAATC -> CTGATGAATCC
GCTGCAGTTCC -> CTGCAGTTCCG
GCTGCCTCCGT -> CTGCCTCCGTG
GCTGGATGGCC -> CTGGATGGCCT
GCTGGGAGTGC -> CTGGGAGTGCT
GCTGTTGGTCG -> CTGTTGGTCGG
GCTTAAACCAG -> CTTAAACCAGA
GCTTCAGTGAA -> CTTCAGTGAAC
GCTTCCTTCTG -> CTTCCTTCTGC
GCTTGCTCCTC -> CTTGCTCCTCA
GCTTGTCATGG -> CTTGTCATGGG
GGAAAGTTAAA -> GAAAGTTAAAA
GGAAATATAAC -> GAAATATAACT
GGAACACTCCT -> GAACACTCCTC
GGAACGAGAGA -> GAACGAGAGAA
GGAACTACCAA -> GAACTACCAAT
GGAAGCTTAAA -> GAAGCTTAAAC
GGAAGGTACGA -> GAAGGTACGAC
GGAAGTTATGT -> GAAGTTATGTC
GGAATGAGAAA -> GAATGAGAAAC
GGACAGTATCG -> GACAGTATCGT
GGACCATCTCC -> GACCATCTCCG
GGACCCCTCAC -> GACCCCTCACC
GGACCCGCTGC -> GACCCGCTGCC
GGACCGGGAAC -> GACCGGGAACT
GGACGACTAGC -> GACGACTAGCA
GGACTCACCTA -> GACTCACCTAC
GGACTGTCAAT -> GACTGTCAATG
GGACTTGACAT -> GACTTGACATG
GGAGCATAAGC -> GAGCATAAGCC
GGAGCTAGTAG -> GAGCTAGTAGT
GGAGGTGGGAT -> GAGGTGGGATT
GGAGTGCTGCA -> GAGTGCTGCAG
GGAGTGTGTCT -> GAGTGTGTCTC
GGATCCTGGAT -> GATCCTGGATC
GGATCTGGCGA -> GATCTGGCGAG
GGATCTTCTAT -> GATCTTCTATG
GGATGACGTGC -> GATGACGTGCT
GGATGATTCCT -> GATGATTCCTT
GGATGGCCTTC -> GATGGCCTTCT
GGATTCTGCCA -> GATTCTGCCAC
GGATTGTGGGT -> GATTGTGGGTC
GGCAACTCTGA -> GCAACTCTGAA
GGCAATCCGAG -> GCAATCCGAGC
GGCAATCGGTT -> GCAATCGGTTC
GGCACAGGGTC -> GCACAGGGTCT
GGCAGAATCCG -> GCAGAATCCGG
GGCCCCACACA -> GCCCCACACAT
GGCCGATGAGG -> GCCGATGAGGA
GGCCGTTTACA -> GCCGTTTACAA
GGCCGTTTTTA -> GCCGTTTTTAA
GGCCTAACGTT -> GCCTAACGTTT
GGCCTTCTGAC -> GCCTTCTGACG
GGCCTTGTCAG -> GCCTTGTCAGT
GGCGAGATGTG -> GCGAGATGTGG
GGCGAGTTCAT -> GCGAGTTCATG
GGCGCGATTTA -> GCGCGATTTAA
GGCGCTAACGG -> GCGCTAACGGG
GGCGTACAAAC -> GCGTACAAACG
GGCTAAACGCC -> GCTAAACGCCA
GGCTCAGTAGA -> GCTCAGTAGAC
GGCTCATACCG -> GCTCATACCGG
GGCTCGTACGC -> GCTCGTACGCC
GGCTGATGAAT -> GCTGATGAATC
GGCTGGATGGC -> GCTGGATGGCC
GGCTTCCTTCT -> GCTTCCTTCTG
GGCTTGCTCCT -> GCTTGCTCCTC
GGCTTGTCATG -> GCTTGTCATGG
GGGAACGAGAG -> GGAACGAGAGA
GGGAACTACCA -> GGAACTACCAA
GGGAAGTTATG -> GGAAGTTATGT
GGGACCATCTC -> GGACCATCTCC
GGGACTGTCAA -> GGACTGTCAAT
GGGAGCTAGTA -> GGAGCTAGTAG
GGGAGGTGGGA -> GGAGGTGGGAT
GGGAGTGCTGC -> GGAGTGCTGCA
GGGATCCTGGA -> GGATCCTGGAT
GGGATTCTGCC -> GGATTCTGCCA
GGGCAACTCTG -> GGCAACTCTGA
GGGCCGTTTTT -> GGCCGTTTTTA
GGGCCTAACGT -> GGCCTAACGTT
GGGCGAGATGT -> GGCGAGATGTG
GGGCGTACAAA -> GGCGTACAAAC
GGGCTAAACGC -> GGCTAAACGCC
GGGCTCAGTAG -> GGCTCAGTAGA
GGGGCCGTTTT -> GGGCCGTTTTT
GGGGCGTACAA -> GGGCGTACAAA
GGGGTGTTAGA -> GGGTGTTAGAC
GGGTACCTAAG -> GGTACCTAAGG
GGGTATCAAGG -> GGTATCAAGGA
GGGTCCATAAA -> GGTCCATAAAG
GGGTCCATTGA -> GGTCCATTGAT
GGGTCTCCCAA -> GGTCTCCCAAT
GGGTCTTTGTA -> GGTCTTTGTAT
GGGTGCGTAGC -> GGTGCGTAGCC
GGGTGGATTGT -> GGTGGATTGTG
GGGTGGCCCCA -> GGTGGCCCCAC
GGGTGTTAGAC -> GGTGTTAGACG
GGGTTTCAACC -> GGTTTCAACCT
GGTAAGTCACA -> GTAAGTCACAT
GGTACAACGCA -> GTACAACGCAG
GGTACCTAAGG -> GTACCTAAGGC
GGTACGACGGT -> GTACGACGGTT
GGTACTATCCC -> GTACTATCCCT
GGTACTTTGAT -> GTACTTTGATA
GGTATACTTAC -> GTATACTTACG
GGTATCAAGGA -> GTATCAAGGAT
GGTATCCCTGG -> GTATCCCTGGG
GGTCATTGTCC -> GTCATTGTCCC
GGTCCATAAAG -> GTCCATAAAGA
GGTCCATTGAT -> GTCCATTGATA
GGTCCCAGTGA -> GTCCCAGTGAG
GGTCGCTCTCC -> GTCGCTCTCCT
GGTCGGTGCTC -> GTCGGTGCTCG
GGTCTCCCAAT -> GTCTCCCAATT
GGTCTTTGTAT -> GTCTTTGTATT
GGTGCATACAT -> GTGCATACATT
GGTGCGTAGCC -> GTGCGTAGCCA
GGTGCTCGAAT -> GTGCTCGAATG
GGTGGATTGTG -> GTGGATTGTGG
GGTGGCCCCAC -> GTGGCCCCACA
GGTGGGATTCT -> GTGGGATTCTG
GGTGGTACAAC -> GTGGTACAACG
GGTGTTAAATG -> GTGTTAAATGT
GGTGTTAGACG -> GTGTTAGACGT
GGTTACATAAA -> GTTACATAAAA
GGTTACCACAC -> GTTACCACACA
GGTTCAAGGGT -> GTTCAAGGGTC
GGTTCGGGAGG -> GTTCGGGAGGT
GGTTGGAAAGT -> GTTGGAAAGTT
GGTTGGGTACC -> GTTGGGTACCT
GGTTGTTTTAT -> GTTGTTTTATT
GGTTTATCGTC -> GTTTATCGTCC
GGTTTATCTGG -> GTTTATCTGGT
GGTTTCAACCT -> GTTTCAACCTA
GGTTTCTCCTC -> GTTTCTCCTCG
GTAAAGCCTCG -> TAAAGCCTCGT
GTAACAAAAAC -> TAACAAAAACG
GTAACATTCGG -> TAACATTCGGC
GTAAGTCACAT -> TAAGTCACATT
GTACAAACGGC -> TACAAACGGCA
GTACAACGCAG -> TACAACGCAGG
GTACAGATTCC -> TACAGATTCCC
GTACCCTCGCA -> TACCCTCGCAC
GTACCTAAGGC -> TACCTAAGGCG
GTACGACGGTT -> TACGACGGTTG
GTACGCCTTCC -> TACGCCTTCCC
GTACTATCCCT -> TACTATCCCTG
GTACTCCCGTC -> TACTCCCGTCG
GTACTTTGATA -> TACTTTGATAT
GTAGACAGTAT -> TAGACAGTATG
GTAGACCAGCG -> TAGACCAGCGG
GTAGACCCGTA -> TAGACCCGTAA
GTAGAGGTACT -> TAGAGGTACTA
GTAGCCACAGG -> TAGCCACAGGT
GTAGCTAGGCA -> TAGCTAGGCAG
GTAGTAGAGGT -> TAGTAGAGGTA
GTATACTGTCC -> TATACTGTCCC
GTATACTTACG -> TATACTTACGC
GTATAGTATAC -> TATAGTATACT
GTATCAAGGAT -> TATCAAGGATG
GTATCCCTGGG -> TATCCCTGGGT
GTATCGTTAAT -> TATCGTTAATG
GTATGAAAGGA -> TATGAAAGGAC
GTATTAAGAGT -> TATTAAGAGTT
GTCAAAGATTA -> TCAAAGATTAA
GTCAATGAGCG -> TCAATGAGCGC
GTCACATTGTG -> TCACATTGTGA
GTCAGATAGAA -> TCAGATAGAAA
GTCAGCCCCGG -> TCAGCCCCGGC
GTCAGTCGCGA -> TCAGTCGCGAC
GTCATACGATT -> TCATACGATTC
GTCATGGGTCC -> TCATGGGTCCA
GTCATTGTCCC -> TCATTGTCCCA
GTCCACGTAGC -> TCCACGTAGCT
GTCCATAAAGA -> TCCATAAAGAA
GTCCATTGATA -> TCCATTGATAA
GTCCCACATAG -> TCCCACATAGT
GTCCCAGTGAG -> TCCCAGTGAGC
GTCCCCTCGGA -> TCCCCTCGGAA
GTCCCTACTCT -> TCCCTACTCTC
GTCCTAGGCAA -> TCCTAGGCAAT
GTCCTTGTACA -> TCCTTGTACAG
GTCGCAATGGT -> TCGCAATGGTT
GTCGCACTGTG -> TCGCACTGTGC
GTCGCGACCGC -> TCGCGACCGCG
GTCGCTCTCCT -> TCGCTCTCCTA
GTCGGTGCTCG -> TCGGTGCTCGA
GTCGGTTTCTC -> TCGGTTTCTCC
GTCTCCCAATT -> TCTCCCAATTC
GTCTCTCACAG -> TCTCTCACAGG
GTCTGGAGTGT -> TCTGGAGTGTG
GTCTTGAGAAG -> TCTTGAGAAGT
GTCTTGATACA -> TCTTGATACAG
GTCTTTCCTAT -> TCTTTCCTATA
GTCTTTGTATT -> TCTTTGTATTA
GTGAACTCCAC -> TGAACTCCACG
GTGAACTTAAG -> TGAACTTAAGG
GTGAAGGCCGA -> TGAAGGCCGAT
GTGACAGTGCC -> TGACAGTGCCT
GTGAGCTTCAG -> TGAGCTTCAGT
GTGATAATAGT -> TGATAATAGTG
GTGCAGCCTGC -> TGCAGCCTGCC
GTGCATACATT -> TGCATACATTT
GTGCCTCGCAT -> TGCCTCGCATA
GTGCGTAGCCA -> TGCGTAGCCAC
GTGCTAACTAT -> TGCTAACTATC
GTGCTCGAATG -> TGCTCGAATGG
GTGCTGCAGTT -> TGCTGCAGTTC
GTGGATTGTGG -> TGGATTGTGGG
GTGGCCCCACA -> TGGCCCCACAC
GTGGCTTCCTT -> TGGCTTCCTTC
GTGGCTTGCTC -> TGGCTTGCTCC
GTGGCTTGTCA -> TGGCTTGTCAT
GTGGGACTGTC -> TGGGACTGTCA
GTGGGATTCTG -> TGGGATTCTGC
GTGGGCAACTC -> TGGGCAACTCT
GTGGGTATCAA -> TGGGTATCAAG
GTGGGTCCATT -> TGGGTCCATTG
GTGGTACAACG -> TGGTACAACGC
GTGTCTCTCAC -> TGTCTCTCACA
GTGTGGGACTG -> TGTGGGACTGT
GTGTGTCTCTC -> TGTGTCTCTCA
GTGTTAAATGT -> TGTTAAATGTT
GTGTTAGACGT -> TGTTAGACGTC
GTTAAAAGAAG -> TTAAAAGAAGG
GTTAAATGTTG -> TTAAATGTTGA
GTTAATGTGTG -> TTAATGTGTGG
GTTACATAAAA -> TTACATAAAAT
GTTACCACACA -> TTACCACACAG
GTTACCCATTC -> TTACCCATTCA
GTTAGACGTCC -> TTAGACGTCCC
GTTATGAACCT -> TTATGAACCTA
GTTATGTCAGC -> TTATGTCAGCC
GTTCAAGGGTC -> TTCAAGGGTCT
GTTCATGCGCC -> TTCATGCGCCA
GTTCCGGCTGG -> TTCCGGCTGGA
GTTCGGGAGGT -> TTCGGGAGGTG
GTTCGGGGCGT -> TTCGGGGCGTA
GTTCTGGGTGG -> TTCTGGGTGGA
GTTCTTACTCA -> TTCTTACTCAC
GTTCTTTCTCC -> TTCTTTCTCCT
GTTGAACTGAC -> TTGAACTGACA
GTTGAGTTCGG -> TTGAGTTCGGG
GTTGGAAAGTT -> TTGGAAAGTTA
GTTGGACCCCT -> TTGGACCCCTC
GTTGGGTACCT -> TTGGGTACCTA
GTTGGTCGGTG -> TTGGTCGGTGC
GTTGTTTTATT -> TTGTTTTATTT
GTTTACAATGA -> TTTACAATGAA
GTTTATCGTCC -> TTTATCGTCCT
GTTTATCTGGT -> TTTATCTGGTT
GTTTCAACCTA -> TTTCAACCTAA
GTTTCCGCAAT -> TTTCCGCAATC
GTTTCTCCTCG -> TTTCTCCTCGG
GTTTGCACAGG -> TTTGCACAGGT
GTTTGGGCTAA -> TTTGGGCTAAA
GTTTGTCGCAC -> TTTGTCGCACT
GTTTTATTTTT -> TTTTATTTTTG
GTTTTTAACTC -> TTTTTAACTCG
TAAAAGAAGGC -> AAAAGAAGGCC
TAAAATGATCA -> AAAATGATCAC
TAAACCAGAGG -> AAACCAGAGGT
TAAACGCCATC -> AAACGCCATCA
TAAACGTCCTA -> AAACGTCCTAG
TAAACTCGCAA -> AAACTCGCAAC
TAAAGAAGCGA -> AAAGAAGCGAC
TAAAGCCTCGT -> AAAGCCTCGTA
TAAATGAATAC -> AAATGAATACC
TAAATGTTGAG -> AAATGTTGAGT
TAACAAAAACG -> AACAAAAACGA
TAACATTCGGC -> AACATTCGGCA
TAACGGGCTCA -> AACGGGCTCAG
TAACGTTTGTC -> AACGTTTGTCG
TAACTATCCAC -> AACTATCCACT
TAACTCGCTAG -> AACTCGCTAGG
TAACTGCACAT -> AACTGCACATT
TAACTGCCAGC -> AACTGCCAGCC
TAACTTCCGGT -> AACTTCCGGTT
TAACTTGCAAC -> AACTTGCAACC
TAAGAGTTTGG -> AAGAGTTTGGG
TAAGCCATTGT -> AAGCCATTGTC
TAAGCCCCTCC -> AAGCCCCTCCG
TAAGGCGCTAA -> AAGGCGCTAAC
TAAGGGGTGTT -> AAGGGGTGTTA
TAAGGTTACAT -> AAGGTTACATA
TAAGTACCCTC -> AAGTACCCTCG
TAAGTCACATT -> AAGTCACATTG
TAATAACTGCA -> AATAACTGCAC
TAATAGTGAAG -> AATAGTGAAGG
TAATCATGACT -> AATCATGACTC
TAATCGAGGTT -> AATCGAGGTTG
TAATGTGTGGG -> AATGTGTGGGA
TAATTCTGTCT -> AATTCTGTCTG
TACAAACGGCA -> ACAAACGGCAC
TACAAACTGAG -> ACAAACTGAGC
TACAACGCAGG -> ACAACGCAGGG
TACAATGAAAG -> ACAATGAAAGT
TACAGAGCCCT -> ACAGAGCCCTA
TACAGATTCCC -> ACAGATTCCCG
TACATAAAATG -> ACATAAAATGA
TACATTTAATC -> ACATTTAATCG
TACATTTCAAA -> ACATTTCAAAA
TACCAATGAAC -> ACCAATGAACG
TACCACACAGG -> ACCACACAGGT
TACCACGAGTT -> ACCACGAGTTA
TACCCATTCAA -> ACCCATTCAAG
TACCCTCGCAC -> ACCCTCGCACC
TACCGGAAATA -> ACCGGAAATAT
TACCTAAGGCG -> ACCTAAGGCGC
TACCTCTACAT -> ACCTCTACATT
TACCTCTTGTC -> ACCTCTTGTCA
TACCTCTTTAC -> ACCTCTTTACG
TACGACCCCTG -> ACGACCCCTGT
TACGACGGTTG -> ACGACGGTTGG
TACGATTCTCT -> ACGATTCTCTT
TACGCCTTCCC -> ACGCCTTCCCG
TACGCTGTTGG -> ACGCTGTTGGT
TACGGAACACT -> ACGGAACACTC
TACGTTTGCAC -> ACGTTTGCACA
TACTATCCCTG -> ACTATCCCTGT
TACTCAAAACG -> ACTCAAAACGG
TACTCACGGGA -> ACTCACGGGAA
TACTCCCCCAT -> ACTCCCCCATA
TACTCCCGTCG -> ACTCCCGTCGG
TACTCTCAAGT -> ACTCTCAAGTC
TACTGTCCCTA -> ACTGTCCCTAC
TACTTACGCTG -> ACTTACGCTGT
TACTTTGATAT -> ACTTTGATATA
TAGAAATGTCC -> AGAAATGTCCA
TAGACAGTATG -> AGACAGTATGA
TAGACCAGCGG -> AGACCAGCGGC
TAGACCCGTAA -> AGACCCGTAAC
TAGACGTCCCC -> AGACGTCCCCT
TAGACTCGCAT -> AGACTCGCATT
TAGAGGTACTA -> AGAGGTACTAT
TAGCACTGTGG -> AGCACTGTGGC
TAGCCACAGGT -> AGCCACAGGTT
TAGCGTTCTGG -> AGCGTTCTGGG
TAGCTAGGCAG -> AGCTAGGCAGA
TAGGACTTGAC -> AGGACTTGACA
TAGGCAATCCG -> AGGCAATCCGA
TAGGCAGAATC -> AGGCAGAATCC
TAGTAAAGCCT -> AGTAAAGCCTC
TAGTAGAGGTA -> AGTAGAGGTAC
TAGTAGTAGAG -> AGTAGTAGAGG
TAGTATACTGT -> AGTATACTGTC
TAGTGAAGGCC -> AGTGAAGGCCG
TAGTGACAGTG -> AGTGACAGTGC
TATAAACTCGC -> ATAAACTCGCA
TATAACTTCCG -> ATAACTTCCGG
TATACGTTTGC -> ATACGTTTGCA
TATACTCCCCC -> ATACTCCCCCA
TATACTGTCCC -> ATACTGTCCCT
TATACTTACGC -> ATACTTACGCT
TATAGTATACT -> ATAGTATACTG
TATATACGTTT -> ATATACGTTTG
TATCAAGGATG -> ATCAAGGATGA
TATCATAGCGT -> ATCATAGCGTT
TATCCACTCCT -> ATCCACTCCTG
TATCCCTGGGT -> ATCCCTGGGTT
TATCCCTGTCA -> ATCCCTGTCAT
TATCGTCCTTG -> ATCGTCCTTGT
TATCGTTAATG -> ATCGTTAATGT
TATCTGGTTTA -> ATCTGGTTTAT
TATGAAAGGAC -> ATGAAAGGACT
TATGAACCTAA -> ATGAACCTAAA
TATGAATGTCT -> ATGAATGTCTT
TATGATTCTCA -> ATGATTCTCAT
TATGCAAAGCA -> ATGCAAAGCAG
TATGTCAGCCC -> ATGTCAGCCCC
TATTAAGAGTT -> ATTAAGAGTTT
TATTTGCCGTA -> ATTTGCCGTAT
TATTTTTGAAG -> ATTTTTGAAGG
TCAAAACGGTC -> CAAAACGGTCG
TCAAAATCAAC -> CAAAATCAACA
TCAAACGTACT -> CAAACGTACTC
TCAAAGATTAA -> CAAAGATTAAC
TCAACATTATG -> CAACATTATGA
TCAACCTAAGC -> CAACCTAAGCC
TCAAGGATGAT -> CAAGGATGATT
TCAAGGGTCTT -> CAAGGGTCTTT
TCAAGGTGCAT -> CAAGGTGCATA
TCAAGTCGCAA -> CAAGTCGCAAT
TCAAGTCTTTC -> CAAGTCTTTCC
TCAATGAGCGC -> CAATGAGCGCT
TCAATTAATTC -> CAATTAATTCT
TCACAAGGACG -> CACAAGGACGA
TCACAGGAAGG -> CACAGGAAGGT
TCACATTGTGA -> CACATTGTGAT
TCACCGGATCT -> CACCGGATCTG
TCACCTACGGA -> CACCTACGGAA
TCACCTCTTCT -> CACCTCTTCTA
TCACGGGAACG -> CACGGGAACGA
TCACTAAGGGG -> CACTAAGGGGT
TCAGATAGAAA -> CAGATAGAAAT
TCAGATCCGGC -> CAGATCCGGCC
TCAGATTCTTC -> CAGATTCTTCA
TCAGCCCCGGC -> CAGCCCCGGCG
TCAGTAGACAG -> CAGTAGACAGT
TCAGTCGCGAC -> CAGTCGCGACC
TCAGTGAACTT -> CAGTGAACTTA
TCATACCGGAA -> CATACCGGAAA
TCATACGATTC -> CATACGATTCT
TCATAGCGTTC -> CATAGCGTTCT
TCATGACAGTC -> CATGACAGTCA
TCATGACTCAA -> CATGACTCAAA
TCATGCGCCAA -> CATGCGCCAAA
TCATGGGTCCA -> CATGGGTCCAT
TCATGGTCCCA -> CATGGTCCCAG
TCATTGTCCCA -> CATTGTCCCAC
TCCACGCCGGA -> CCACGCCGGAA
TCCACGTAGCT -> CCACGTAGCTA
TCCACTCCTGA -> CCACTCCTGAA
TCCATAAAGAA -> CCATAAAGAAG
TCCATATACTC -> CCATATACTCC
TCCATTGATAA -> CCATTGATAAG
TCCCAACAAGC -> CCCAACAAGCC
TCCCAATTCGA -> CCCAATTCGAA
TCCCACATAGT -> CCCACATAGTG
TCCCAGTGAGC -> CCCAGTGAGCT
TCCCCCATACA -> CCCCCATACAT
TCCCCTCGGAA -> CCCCTCGGAAG
TCCCGAACGGG -> CCCGAACGGGA
TCCCGACCAAT -> CCCGACCAATT
TCCCGTCGGTT -> CCCGTCGGTTT
TCCCTACTCTC -> CCCTACTCTCA
TCCCTGGGTTT -> CCCTGGGTTTC
TCCCTGTCATA -> CCCTGTCATAC
TCCGAGCATCA -> CCGAGCATCAA
TCCGATGGGGC -> CCGATGGGGCC
TCCGCAATCCG -> CCGCAATCCGC
TCCGCACAAGT -> CCGCACAAGTG
TCCGGACCGGG -> CCGGACCGGGA
TCCGGCCGTTT -> CCGGCCGTTTA
TCCGGCTGGAT -> CCGGCTGGATG
TCCGGGTGGCC -> CCGGGTGGCCC
TCCGGTTGTTT -> CCGGTTGTTTT
TCCGTGGCTTG -> CCGTGGCTTGC
TCCTAGGCAAT -> CCTAGGCAATC
TCCTAGTAAAG -> CCTAGTAAAGC
TCCTATATACG -> CCTATATACGT
TCCTCAGATTC -> CCTCAGATTCT
TCCTCGACAAC -> CCTCGACAACC
TCCTCGGGCCT -> CCTCGGGCCTA
TCCTCTTGTTC -> CCTCTTGTTCT
TCCTGAACTGA -> CCTGAACTGAG
TCCTGGATCTT -> CCTGGATCTTC
TCCTGGTACTT -> CCTGGTACTTT
TCCTTATTTGC -> CCTTATTTGCC
TCCTTCTGCCC -> CCTTCTGCCCA
TCCTTCTGGTT -> CCTTCTGGTTC
TCCTTGTACAG -> CCTTGTACAGA
TCGAAAACGGG -> CGAAAACGGGA
TCGAATGGCTG -> CGAATGGCTGA
TCGACAACCAG -> CGACAACCAGT
TCGAGGTTGGA -> CGAGGTTGGAA
TCGCAACACTG -> CGCAACACTGT
TCGCAATGGTT -> CGCAATGGTTT
TCGCACCTCTT -> CGCACCTCTTA
TCGCACTGTGC -> CGCACTGTGCA
TCGCATAACTT -> CGCATAACTTG
TCGCATCCATA -> CGCATCCATAT
TCGCATTCACC -> CGCATTCACCT
TCGCGACCGCG -> CGCGACCGCGT
TCGCTAGGACT -> CGCTAGGACTT
TCGCTCTCCTA -> CGCTCTCCTAG
TCGGAAGCTTA -> CGGAAGCTTAA
TCGGCAATCGG -> CGGCAATCGGT
TCGGGAGGTGG -> CGGGAGGTGGG
TCGGGCCTAAC -> CGGGCCTAACG
TCGGGGCGTAC -> CGGGGCGTACA
TCGGTGCTCGA -> CGGTGCTCGAA
TCGGTTCGGGA -> CGGTTCGGGAG
TCGGTTTCTCC -> CGGTTTCTCCT
TCGTAACATTC -> CGTAACATTCG
TCGTACGCCTT -> CGTACGCCTTC
TCGTCCTTGTA -> CGTCCTTGTAC
TCGTTAATGTG -> CGTTAATGTGT
TCTATCATAGC -> CTATCATAGCG
TCTATGATTCT -> CTATGATTCTC
TCTCAAGTCGC -> CTCAAGTCGCA
TCTCACAGGAA -> CTCACAGGAAG
TCTCATGACAG -> CTCATGACAGT
TCTCCCAATTC -> CTCCCAATTCG
TCTCCGGACCG -> CTCCGGACCGG
TCTCCTAGTAA -> CTCCTAGTAAA
TCTCCTCGGGC -> CTCCTCGGGCC
TCTCCTTATTT -> CTCCTTATTTG
TCTCTCACAGG -> CTCTCACAGGA
TCTCTTGGGAA -> CTCTTGGGAAG
TCTGAAGCCGC -> CTGAAGCCGCA
TCTGACGAGGA -> CTGACGAGGAT
TCTGCCACCCC -> CTGCCACCCCA
TCTGCCCAGCT -> CTGCCCAGCTC
TCTGGAGTGTG -> CTGGAGTGTGT
TCTGGCGAGTT -> CTGGCGAGTTC
TCTGGGTGGAT -> CTGGGTGGATT
TCTGGTTCAAG -> CTGGTTCAAGG
TCTGGTTTATC -> CTGGTTTATCG
TCTGTCTGGAG -> CTGTCTGGAGT
TCTTACTCACG -> CTTACTCACGG
TCTTATGCAAA -> CTTATGCAAAG
TCTTCAGATCC -> CTTCAGATCCG
TCTTCTATCAT -> CTTCTATCATA
TCTTCTATGAT -> CTTCTATGATT
TCTTGAGAAGT -> CTTGAGAAGTT
TCTTGATACAG -> CTTGATACAGA
TCTTGGGAAGT -> CTTGGGAAGTT
TCTTGTCAGAT -> CTTGTCAGATA
TCTTGTTCTTA -> CTTGTTCTTAC
TCTTTACGACC -> CTTTACGACCC
TCTTTCCTATA -> CTTTCCTATAT
TCTTTCTCCTT -> CTTTCTCCTTA
TCTTTGTATTA -> CTTTGTATTAA
TGAAAGGACTC -> GAAAGGACTCA
TGAAAGTTCTT -> GAAAGTTCTTT
TGAACCTAAAC -> GAACCTAAACG
TGAACGTAGAC -> GAACGTAGACC
TGAACTCCACG -> GAACTCCACGC
TGAACTGACAC -> GAACTGACACT
TGAACTGAGGC -> GAACTGAGGCT
TGAACTTAAGG -> GAACTTAAGGT
TGAAGCCGCAG -> GAAGCCGCAGT
TGAAGCGACAA -> GAAGCGACAAA
TGAAGGCCGAT -> GAAGGCCGATG
TGAAGGGTGCG -> GAAGGGTGCGT
TGAATACCTCT -> GAATACCTCTT
TGAATCCTGGT -> GAATCCTGGTA
TGAATGTCTTG -> GAATGTCTTGA
TGACACTACCA -> GACACTACCAC
TGACAGTCAAA -> GACAGTCAAAG
TGACAGTGCCT -> GACAGTGCCTC
TGACATGAAGC -> GACATGAAGCG
TGACGAGGATG -> GACGAGGATGA
TGACGTGCTAA -> GACGTGCTAAC
TGACTCAAACG -> GACTCAAACGT
TGAGAAACAGG -> GAGAAACAGGT
TGAGAAGTTTC -> GAGAAGTTTCC
TGAGCAGACAA -> GAGCAGACAAG
TGAGCGCTGGG -> GAGCGCTGGGA
TGAGCTTCAGT -> GAGCTTCAGTG
TGAGGACCCGC -> GAGGACCCGCT
TGAGGCTCATA -> GAGGCTCATAC
TGAGTTCGGGG -> GAGTTCGGGGC
TGATAAGTACC -> GATAAGTACCC
TGATAATAGTG -> GATAATAGTGA
TGATACAGAGC -> GATACAGAGCC
TGATATAAACT -> GATATAAACTC
TGATCACTAAG -> GATCACTAAGG
TGATGAATCCT -> GATGAATCCTG
TGATTCCTTCT -> GATTCCTTCTG
TGATTCTCATG -> GATTCTCATGA
TGCAAAGCAGC -> GCAAAGCAGCA
TGCAACCAGCC -> GCAACCAGCCT
TGCACAGGTCA -> GCACAGGTCAT
TGCACATTACC -> GCACATTACCT
TGCAGCCTGCC -> GCAGCCTGCCT
TGCAGTTCCGG -> GCAGTTCCGGC
TGCATACATTT -> GCATACATTTC
TGCCACCCCAC -> GCCACCCCACG
TGCCAGCCGAA -> GCCAGCCGAAT
TGCCCAGCTCC -> GCCCAGCTCCC
TGCCGTATAGT -> GCCGTATAGTA
TGCCTAGACTC -> GCCTAGACTCG
TGCCTCCGTGG -> GCCTCCGTGGC
TGCCTCGCATA -> GCCTCGCATAA
TGCGCCAAAGT -> GCGCCAAAGTG
TGCGTAGCCAC -> GCGTAGCCACA
TGCTAACTATC -> GCTAACTATCC
TGCTCCTCAGA -> GCTCCTCAGAT
TGCTCGAATGG -> GCTCGAATGGC
TGCTGCAGTTC -> GCTGCAGTTCC
TGGAAAGTTAA -> GGAAAGTTAAA
TGGACCCCTCA -> GGACCCCTCAC
TGGAGTGTGTC -> GGAGTGTGTCT
TGGATCTTCTA -> GGATCTTCTAT
TGGATGGCCTT -> GGATGGCCTTC
TGGATTGTGGG -> GGATTGTGGGT
TGGCCCCACAC -> GGCCCCACACA
TGGCCTTCTGA -> GGCCTTCTGAC
TGGCGAGTTCA -> GGCGAGTTCAT
TGGCTGATGAA -> GGCTGATGAAT
TGGCTTCCTTC -> GGCTTCCTTCT
TGGCTTGCTCC -> GGCTTGCTCCT
TGGCTTGTCAT -> GGCTTGTCATG
TGGGAAGTTAT -> GGGAAGTTATG
TGGGACTGTCA -> GGGACTGTCAA
TGGGAGTGCTG -> GGGAGTGCTGC
TGGGATTCTGC -> GGGATTCTGCC
TGGGCAACTCT -> GGGCAACTCTG
TGGGCTAAACG -> GGGCTAAACGC
TGGGGCCGTTT -> GGGGCCGTTTT
TGGGTACCTAA -> GGGTACCTAAG
TGGGTATCAAG -> GGGTATCAAGG
TGGGTCCATAA -> GGGTCCATAAA
TGGGTCCATTG -> GGGTCCATTGA
TGGGTGGATTG -> GGGTGGATTGT
TGGGTTTCAAC -> GGGTTTCAACC
TGGTACAACGC -> GGTACAACGCA
TGGTACTTTGA -> GGTACTTTGAT
TGGTCCCAGTG -> GGTCCCAGTGA
TGGTCGGTGCT -> GGTCGGTGCTC
TGGTTCAAGGG -> GGTTCAAGGGT
TGGTTTATCGT -> GGTTTATCGTC
TGGTTTATCTG -> GGTTTATCTGG
TGTACAGATTC -> GTACAGATTCC
TGTATTAAGAG -> GTATTAAGAGT
TGTCAATGAGC -> GTCAATGAGCG
TGTCAGATAGA -> GTCAGATAGAA
TGTCAGCCCCG -> GTCAGCCCCGG
TGTCAGTCGCG -> GTCAGTCGCGA
TGTCATACGAT -> GTCATACGATT
TGTCATGGGTC -> GTCATGGGTCC
TGTCCACGTAG -> GTCCACGTAGC
TGTCCCACATA -> GTCCCACATAG
TGTCCCTACTC -> GTCCCTACTCT
TGTCGCACTGT -> GTCGCACTGTG
TGTCTCTCACA -> GTCTCTCACAG
TGTCTGGAGTG -> GTCTGGAGTGT
TGTCTTGAGAA -> GTCTTGAGAAG
TGTCTTGATAC -> GTCTTGATACA
TGTGATAATAG -> GTGATAATAGT
TGTGCAGCCTG -> GTGCAGCCTGC
TGTGGCTTCCT -> GTGGCTTCCTT
TGTGGCTTGTC -> GTGGCTTGTCA
TGTGGGACTGT -> GTGGGACTGTC
TGTGGGCAACT -> GTGGGCAACTC
TGTGGGTCCAT -> GTGGGTCCATT
TGTGTCTCTCA -> GTGTCTCTCAC
TGTGTGGGACT -> GTGTGGGACTG
TGTTAAATGTT -> GTTAAATGTTG
TGTTAGACGTC -> GTTAGACGTCC
TGTTCTTACTC -> GTTCTTACTCA
TGTTGAGTTCG -> GTTGAGTTCGG
TGTTGGACCCC -> GTTGGACCCCT
TGTTGGTCGGT -> GTTGGTCGGTG
TGTTTTATTTT -> GTTTTATTTTT
TTAAAAGAAGG -> TAAAAGAAGGC
TTAAACCAGAG -> TAAACCAGAGG
TTAAATGAATA -> TAAATGAATAC
TTAAATGTTGA -> TAAATGTTGAG
TTAACTCGCTA -> TAACTCGCTAG
TTAACTGCCAG -> TAACTGCCAGC
TTAAGAGTTTG -> TAAGAGTTTGG
TTAAGGTTACA -> TAAGGTTACAT
TTAATCGAGGT -> TAATCGAGGTT
TTAATGTGTGG -> TAATGTGTGGG
TTAATTCTGTC -> TAATTCTGTCT
TTACAAACTGA -> TACAAACTGAG
TTACAATGAAA -> TACAATGAAAG
TTACATAAAAT -> TACATAAAATG
TTACCACACAG -> TACCACACAGG
TTACCCATTCA -> TACCCATTCAA
TTACCTCTACA -> TACCTCTACAT
TTACCTCTTTA -> TACCTCTTTAC
TTACGACCCCT -> TACGACCCCTG
TTACGCTGTTG -> TACGCTGTTGG
TTACTCACGGG -> TACTCACGGGA
TTAGACGTCCC -> TAGACGTCCCC
TTATCGTCCTT -> TATCGTCCTTG
TTATCTGGTTT -> TATCTGGTTTA
TTATGAACCTA -> TATGAACCTAA
TTATGAATGTC -> TATGAATGTCT
TTATGCAAAGC -> TATGCAAAGCA
TTATGTCAGCC -> TATGTCAGCCC
TTATTTGCCGT -> TATTTGCCGTA
TTATTTTTGAA -> TATTTTTGAAG
TTCAAAATCAA -> TCAAAATCAAC
TTCAACCTAAG -> TCAACCTAAGC
TTCAAGGGTCT -> TCAAGGGTCTT
TTCAAGTCTTT -> TCAAGTCTTTC
TTCACCTCTTC -> TCACCTCTTCT
TTCAGATCCGG -> TCAGATCCGGC
TTCAGTGAACT -> TCAGTGAACTT
TTCATGCGCCA -> TCATGCGCCAA
TTCCCGAACGG -> TCCCGAACGGG
TTCCCGACCAA -> TCCCGACCAAT
TTCCGCAATCC -> TCCGCAATCCG
TTCCGGCTGGA -> TCCGGCTGGAT
TTCCGGTTGTT -> TCCGGTTGTTT
TTCCTATATAC -> TCCTATATACG
TTCCTTCTGCC -> TCCTTCTGCCC
TTCCTTCTGGT -> TCCTTCTGGTT
TTCGAAAACGG -> TCGAAAACGGG
TTCGGCAATCG -> TCGGCAATCGG
TTCGGGAGGTG -> TCGGGAGGTGG
TTCGGGGCGTA -> TCGGGGCGTAC
TTCTATCATAG -> TCTATCATAGC
TTCTATGATTC -> TCTATGATTCT
TTCTCATGACA -> TCTCATGACAG
TTCTCCTCGGG -> TCTCCTCGGGC
TTCTCCTTATT -> TCTCCTTATTT
TTCTCTTGGGA -> TCTCTTGGGAA
TTCTGACGAGG -> TCTGACGAGGA
TTCTGCCACCC -> TCTGCCACCCC
TTCTGCCCAGC -> TCTGCCCAGCT
TTCTGGGTGGA -> TCTGGGTGGAT
TTCTGGTTCAA -> TCTGGTTCAAG
TTCTGTCTGGA -> TCTGTCTGGAG
TTCTTACTCAC -> TCTTACTCACG
TTCTTCAGATC -> TCTTCAGATCC
TTCTTTCTCCT -> TCTTTCTCCTT
TTGAACTGACA -> TGAACTGACAC
TTGAAGGGTGC -> TGAAGGGTGCG
TTGACATGAAG -> TGACATGAAGC
TTGAGAAGTTT -> TGAGAAGTTTC
TTGAGTTCGGG -> TGAGTTCGGGG
TTGATAAGTAC -> TGATAAGTACC
TTGATACAGAG -> TGATACAGAGC
TTGATATAAAC -> TGATATAAACT
TTGCAACCAGC -> TGCAACCAGCC
TTGCACAGGTC -> TGCACAGGTCA
TTGCCGTATAG -> TGCCGTATAGT
TTGCTCCTCAG -> TGCTCCTCAGA
TTGGAAAGTTA -> TGGAAAGTTAA
TTGGACCCCTC -> TGGACCCCTCA
TTGGGAAGTTA -> TGGGAAGTTAT
TTGGGCTAAAC -> TGGGCTAAACG
TTGGGTACCTA -> TGGGTACCTAA
TTGGTCGGTGC -> TGGTCGGTGCT
TTGTACAGATT -> TGTACAGATTC
TTGTATTAAGA -> TGTATTAAGAG
TTGTCAGATAG -> TGTCAGATAGA
TTGTCAGTCGC -> TGTCAGTCGCG
TTGTCATGGGT -> TGTCATGGGTC
TTGTCCCACAT -> TGTCCCACATA
TTGTCGCACTG -> TGTCGCACTGT
TTGTCTTGAGA -> TGTCTTGAGAA
TTGTGATAATA -> TGTGATAATAG
TTGTGGGTCCA -> TGTGGGTCCAT
TTGTTCTTACT -> TGTTCTTACTC
TTGTTTTATTT -> TGTTTTATTTT
TTTAAATGAAT -> TTAAATGAATA
TTTAACTCGCT -> TTAACTCGCTA
TTTAATCGAGG -> TTAATCGAGGT
TTTACAATGAA -> TTACAATGAAA
TTTACGACCCC -> TTACGACCCCT
TTTATCGTCCT -> TTATCGTCCTT
TTTATCTGGTT -> TTATCTGGTTT
TTTATTTTTGA -> TTATTTTTGAA
TTTCAAAATCA -> TTCAAAATCAA
TTTCAACCTAA -> TTCAACCTAAG
TTTCCGCAATC -> TTCCGCAATCC
TTTCCTATATA -> TTCCTATATAC
TTTCTCCTCGG -> TTCTCCTCGGG
TTTCTCCTTAT -> TTCTCCTTATT
TTTGAAGGGTG -> TTGAAGGGTGC
TTTGATATAAA -> TTGATATAAAC
TTTGCACAGGT -> TTGCACAGGTC
TTTGCCGTATA -> TTGCCGTATAG
TTTGGGCTAAA -> TTGGGCTAAAC
TTTGTATTAAG -> TTGTATTAAGA
TTTGTCGCACT -> TTGTCGCACTG
TTTTAACTCGC -> TTTAACTCGCT
TTTTATTTTTG -> TTTATTTTTGA
TTTTGAAGGGT -> TTTGAAGGGTG
TTTTTAACTCG -> TTTTAACTCGC
TTTTTGAAGGG -> TTTTGAAGGGT
